Id,Label,timeset,indegree,outdegree,Degree,weighted indegree,weighted outdegree,Weighted Degree,Eccentricity,closnesscentrality,harmonicclosnesscentrality,betweenesscentrality,modularity_class,Authority,Hub
1221801193,1221801193,,0,1,1,0,1,1,1,1,1,0,0,0,0
1289758279250452480,1289758279250452480,,1,0,1,1,0,1,0,0,0,0,0,0,0
252565001,252565001,,0,0,0,0,0,0,0,0,0,0,1,0,0
1371162554056257536,1371162554056257536,,0,0,0,0,0,0,0,0,0,0,2,0,0
754229219081805824,754229219081805824,,0,0,0,0,0,0,0,0,0,0,3,0,0
1417609333404311552,1417609333404311552,,0,2,2,0,2,2,9,0.219626,0.235505,0,18,0,0.000511
589253599,589253599,,4,0,4,4,0,4,0,0,0,0,18,0.000872,0
945762882817613824,945762882817613824,,35,66,101,36,69,105,8,0.281123,0.319627,0.000957,18,0.01663,0.00037
1365379693,1365379693,,0,8,8,0,9,9,10,0.216325,0.248807,0,9,0,0.000113
1360232480,1360232480,,6,2,8,13,4,17,2,0.625,0.7,0.000047,9,0.002139,0
396691435,396691435,,1,5,6,1,5,6,6,0.363493,0.407343,0.000007,9,0.000003,0.049703
1429938235082424320,1429938235082424320,,3,27,30,11,27,38,9,0.249701,0.292888,0.000041,18,0.000833,0.006154
1617818378,1617818378,,1,0,1,1,0,1,0,0,0,0,9,0.000003,0
397961650,397961650,,1,2,3,1,2,3,6,0.391484,0.431813,0.000001,9,0.000003,0.007594
1363122959620198400,1363122959620198400,,1,1,2,1,1,2,1,1,1,0,19,0.000003,0.000038
145802194,145802194,,1,3,4,1,3,4,6,0.362106,0.405463,0.000004,9,0.000003,0.013749
1435736186975313920,1435736186975313920,,3,1,4,3,1,4,3,0.444444,0.5,0.000001,15,0.000893,0.000308
1327657796050022400,1327657796050022400,,0,0,0,0,0,0,0,0,0,0,4,0,0
313517712,313517712,,0,2,2,0,2,2,6,0.391245,0.431469,0,5,0,0.004387
1385660793031696384,1385660793031696384,,30,0,30,31,0,31,0,0,0,0,5,0.008118,0
1216846151569301504,1216846151569301504,,267,193,460,267,193,460,5,0.638202,0.802171,0.004273,9,0.142065,0.021591
1709866242,1709866242,,0,1,1,0,1,1,1,1,1,0,18,0,0.000025
2176575594,2176575594,,0,2,2,0,2,2,9,0.219626,0.235505,0,18,0,0.000511
930659928,930659928,,0,6,6,0,6,6,7,0.295158,0.332436,0,18,0,0.028803
107746083,107746083,,61,425,486,69,432,501,8,0.328449,0.424392,0.002386,15,0.035204,0.002599
1300873999312982016,1300873999312982016,,956,1,957,956,1,957,1,1,1,0.000015,5,0.708395,0.003445
483223623,483223623,,253,299,552,254,299,553,7,0.434647,0.577628,0.004827,9,0.163999,0.007191
485538699,485538699,,6,39,45,6,40,46,7,0.299459,0.324076,0.000079,18,0.004513,0.000242
475862409,475862409,,139,99,238,145,103,248,6,0.37321,0.47912,0.001537,14,0.073085,0.000281
1416651131837730816,1416651131837730816,,0,14,14,0,18,18,6,0.443455,0.478179,0,28,0,0.00011
2350541780,2350541780,,1,26,27,3,51,54,6,0.326573,0.36449,0.000001,28,0.000003,0.000023
337767301,337767301,,7,6,13,14,12,26,2,0.875,0.928571,0.000122,9,0.000049,0.000048
1238611928228007936,1238611928228007936,,1,0,1,2,0,2,0,0,0,0,28,0.000003,0
1121542719669723136,1121542719669723136,,9,0,9,10,0,10,0,0,0,0,28,0.000005,0
1325300101,1325300101,,3,0,3,3,0,3,0,0,0,0,28,0.000005,0
3207511185,3207511185,,240,0,240,241,0,241,0,0,0,0,28,0.000758,0
771613884,771613884,,28,0,28,28,0,28,0,0,0,0,28,0.000026,0
52456124,52456124,,3,1,4,3,1,4,1,1,1,0,28,0.000005,0
889570898566672384,889570898566672384,,1,0,1,1,0,1,0,0,0,0,28,0.000003,0
1602771703,1602771703,,1,2,3,1,2,3,1,1,1,0,28,0.000003,0.000001
1216857073,1216857073,,42,22,64,53,26,79,2,0.789474,0.866667,0.000183,28,0.001203,0
5847962,5847962,,14,11,25,16,11,27,3,0.727273,0.833333,0.000003,28,0.000139,0
1181312294313250816,1181312294313250816,,140,338,478,169,343,512,4,0.8159,0.918803,0.003009,28,0.001558,0.000051
1319275574,1319275574,,4,0,4,4,0,4,0,0,0,0,28,0.000004,0
1023826592,1023826592,,0,2,2,0,2,2,3,0.466667,0.52381,0,21,0,0.000096
7622952,7622952,,1,1,2,1,1,2,2,0.666667,0.75,0,21,0.000003,0.000111
1085912953466048512,1085912953466048512,,14,7,21,27,9,36,2,0.769231,0.85,0.00003,19,0.003278,0.01897
1440710794501443584,1440710794501443584,,0,0,0,0,0,0,0,0,0,0,6,0,0
461501385,461501385,,0,1,1,0,1,1,1,1,1,0,28,0,0.000022
249685018,249685018,,0,7,7,0,8,8,9,0.249428,0.283287,0,15,0,0.022627
3138969873,3138969873,,1,0,1,1,0,1,0,0,0,0,15,0.000661,0
1238549771511611392,1238549771511611392,,2,15,17,2,16,18,10,0.215766,0.249108,0.000002,15,0.000968,0.020972
1261991784063926272,1261991784063926272,,12,14,26,15,16,31,8,0.257982,0.281926,0.000219,15,0.005543,0.000089
1323040160,1323040160,,885,1,886,1085,1,1086,1,1,1,0.00003,13,0.61363,0
1254793309324816384,1254793309324816384,,3,0,3,4,0,4,0,0,0,0,250,0.00068,0
1183975875123073024,1183975875123073024,,298,0,298,298,0,298,0,0,0,0,37,0.117923,0
527149082,527149082,,1,1,2,2,1,3,1,1,1,0,28,0.000001,0.000022
2753154182,2753154182,,1,0,1,2,0,2,0,0,0,0,28,0.000001,0
160880868,160880868,,1,1,2,4,2,6,1,1,1,0,28,0.000001,0
720995633168052224,720995633168052224,,1,0,1,2,0,2,0,0,0,0,28,0.000001,0
1449341533258461184,1449341533258461184,,164,0,164,165,0,165,0,0,0,0,28,0.000739,0
1102941035662114816,1102941035662114816,,1,0,1,4,0,4,0,0,0,0,28,0.000001,0
1238386559159873536,1238386559159873536,,1,2,3,2,2,4,1,1,1,0,28,0.000001,0.001814
1344299147264974848,1344299147264974848,,11,15,26,14,16,30,2,0.941176,0.96875,0.000003,28,0.000012,0
1211760506505060352,1211760506505060352,,1,0,1,2,0,2,0,0,0,0,28,0.000001,0
1242386653601312768,1242386653601312768,,1,0,1,2,0,2,0,0,0,0,28,0.000001,0
1365066635002920960,1365066635002920960,,1,0,1,2,0,2,0,0,0,0,28,0.000001,0
1015870262,1015870262,,1,0,1,2,0,2,0,0,0,0,28,0.000001,0
444225252,444225252,,3,5,8,4,5,9,4,0.363636,0.452381,0.000002,28,0.000006,0
231902290,231902290,,1,2,3,2,4,6,1,1,1,0,28,0.000001,0
507697095,507697095,,1,0,1,2,0,2,0,0,0,0,28,0.000001,0
3832977647,3832977647,,1,0,1,2,0,2,0,0,0,0,28,0.000001,0
1047429818004983808,1047429818004983808,,72,0,72,73,0,73,0,0,0,0,28,0.000029,0
955421331994050560,955421331994050560,,3,0,3,6,0,6,0,0,0,0,28,0.000001,0
1369903981510746112,1369903981510746112,,1,0,1,1,0,1,0,0,0,0,28,0.000001,0
529539409,529539409,,1,0,1,1,0,1,0,0,0,0,28,0.000001,0
1432291836920541184,1432291836920541184,,1,5,6,3,5,8,5,0.452874,0.477496,0.000006,28,0.000001,0.000109
975114092183777280,975114092183777280,,1,0,1,1,0,1,0,0,0,0,28,0.000001,0
1305769384510738432,1305769384510738432,,1,0,1,1,0,1,0,0,0,0,28,0.000001,0
2879293835,2879293835,,1,1,2,1,1,2,1,1,1,0,28,0.000001,0.000022
405832858,405832858,,1,1,2,1,1,2,1,1,1,0,28,0.000001,0
874298888,874298888,,0,0,0,0,0,0,0,0,0,0,7,0,0
959523213838610432,959523213838610432,,0,0,0,0,0,0,0,0,0,0,8,0,0
422706269,422706269,,0,4,4,0,5,5,7,0.269023,0.289321,0,206,0,0.004821
700665886823219200,700665886823219200,,4,2,6,7,4,11,1,1,1,0.000006,206,0.000141,0.000022
4645281629,4645281629,,2,7,9,2,7,9,6,0.365059,0.410099,0.000026,18,0.000145,0.036801
436206316,436206316,,1,0,1,1,0,1,0,0,0,0,206,0.000141,0
283416650,283416650,,328,4,332,328,7,335,6,0.393733,0.436217,0.001425,9,0.164622,0.022112
420419717,420419717,,0,1,1,0,1,1,9,0.247311,0.279001,0,15,0,0.001028
1181138850892193792,1181138850892193792,,0,2,2,0,2,2,9,0.225502,0.244848,0,5,0,0.000502
1165978022,1165978022,,12,65,77,13,66,79,8,0.278158,0.309036,0.000337,5,0.005113,0.000344
983761558470823936,983761558470823936,,20,119,139,28,173,201,9,0.264315,0.328634,0.000443,110,0.012072,0.001216
952256618263203840,952256618263203840,,0,1,1,0,1,1,1,1,1,0,28,0,0.000022
1450062950010691584,1450062950010691584,,0,1,1,0,1,1,1,1,1,0,9,0,0.000767
513262856,513262856,,65,0,65,65,0,65,0,0,0,0,9,0.026247,0
493949099,493949099,,0,3,3,0,3,3,8,0.239064,0.251833,0,14,0,0.018006
1194142449310011392,1194142449310011392,,3,1,4,3,1,4,7,0.272226,0.304285,0.000012,14,0.000649,0.002135
804717565,804717565,,3,10,13,3,10,13,7,0.296296,0.315671,0.000027,9,0.002145,0.000057
1417848702631387136,1417848702631387136,,0,2,2,0,2,2,9,0.251897,0.284672,0,5,0,0.001178
423259720,423259720,,0,1,1,0,1,1,8,0.214355,0.229599,0,14,0,0.000019
447170173,447170173,,0,3,3,0,3,3,7,0.334082,0.379265,0,14,0,0.004192
2248443018,2248443018,,7,0,7,7,0,7,0,0,0,0,14,0.000804,0
2436570624,2436570624,,0,0,0,0,0,0,0,0,0,0,10,0,0
917423697979478016,917423697979478016,,0,5,5,0,7,7,9,0.227588,0.24459,0,15,0,0.00022
960110310530142208,960110310530142208,,3,2,5,6,2,8,5,0.434783,0.467143,0.000004,15,0.000695,0.001609
489331719,489331719,,5,1,6,5,1,6,4,0.45,0.486111,0.000006,15,0.001698,0.00027
1424640035404537856,1424640035404537856,,1,1,2,1,1,2,7,0.283203,0.300698,0.000001,15,0.000006,0.004809
1036611673,1036611673,,2,12,14,2,12,14,9,0.24875,0.28787,0.000037,18,0.000016,0.011991
1431924203939368960,1431924203939368960,,0,1,1,0,1,1,1,1,1,0,9,0,0.000767
328473338,328473338,,0,7,7,0,8,8,7,0.275412,0.301855,0,14,0,0.040651
500882938,500882938,,9,15,24,12,15,27,8,0.250604,0.272409,0.000168,14,0.003849,0
543678565,543678565,,44,0,44,44,0,44,0,0,0,0,9,0.020961,0
1287416909676318720,1287416909676318720,,0,0,0,0,0,0,0,0,0,0,11,0,0
1063722252,1063722252,,0,1,1,0,1,1,1,1,1,0,28,0,0
1064261450,1064261450,,0,2,2,0,2,2,3,0.52381,0.575758,0,15,0,0.000795
712647058709155840,712647058709155840,,5,8,13,5,10,15,2,0.9,0.944444,0.000008,15,0.00098,0.021479
1341532922,1341532922,,0,1,1,0,1,1,1,1,1,0,9,0,0.000767
2170468774,2170468774,,0,2,2,0,2,2,9,0.217742,0.231007,0,9,0,0.000916
890555780293951488,890555780293951488,,0,1,1,0,1,1,2,0.666667,0.75,0,13,0,0.017924
1373187695812415488,1373187695812415488,,0,1,1,0,1,1,1,1,1,0,13,0,0.000584
3841429516,3841429516,,55,0,55,57,0,57,0,0,0,0,13,0.02001,0
546654601,546654601,,0,2,2,0,2,2,1,1,1,0,9,0,0.001075
1163905263675543552,1163905263675543552,,30,0,30,30,0,30,0,0,0,0,9,0.010546,0
1359412158094843904,1359412158094843904,,0,1,1,0,1,1,1,1,1,0,21,0,0.000001
1081081891,1081081891,,18,0,18,18,0,18,0,0,0,0,21,0.000028,0
475930507,475930507,,0,0,0,0,0,0,0,0,0,0,12,0,0
902288190,902288190,,0,2,2,0,2,2,6,0.271685,0.295138,0,33,0,0.000023
133342361,133342361,,4,89,93,4,89,93,5,0.371663,0.447115,0.000028,33,0.000021,0
1145734207639101440,1145734207639101440,,0,1,1,0,1,1,1,1,1,0,28,0,0.000022
1337189346433175552,1337189346433175552,,0,2,2,0,2,2,9,0.270489,0.298655,0,250,0,0.001524
1412500075,1412500075,,54,85,139,68,89,157,7,0.315107,0.35663,0.002946,250,0.016953,0.000138
1369668257347739648,1369668257347739648,,0,9,9,0,11,11,9,0.260874,0.305146,0,15,0,0.033808
1432776663851536384,1432776663851536384,,60,1,61,60,2,62,1,1,1,0.000001,21,0.020919,0
1138581484124737536,1138581484124737536,,12,0,12,13,0,13,0,0,0,0,13,0.004517,0
1250825548756107264,1250825548756107264,,1,4,5,1,4,5,4,0.492958,0.535714,0,15,0.000988,0.022054
1364939599601168384,1364939599601168384,,105,50,155,133,56,189,4,0.731183,0.851716,0.000618,15,0.054432,0.00011
1441800666008092672,1441800666008092672,,0,3,3,0,27,27,9,0.226634,0.250309,0,13,0,0.018928
1441789211451949056,1441789211451949056,,20,86,106,56,106,162,8,0.292636,0.350903,0.000718,13,0.00811,0.024884
1034446975,1034446975,,0,7,7,0,7,7,9,0.274446,0.328045,0,15,0,0.016092
406981868,406981868,,40,4,44,42,4,46,3,0.636364,0.761905,0.000048,15,0.014763,0
1059030612051402752,1059030612051402752,,6,1,7,6,1,7,1,1,1,0.00001,15,0.003996,0
970720216551485440,970720216551485440,,0,4,4,0,5,5,2,0.7,0.785714,0,13,0,0.039995
1386786871439659008,1386786871439659008,,0,6,6,0,8,8,9,0.252204,0.285842,0,5,0,0.041172
801867970603601920,801867970603601920,,0,9,9,0,9,9,7,0.290923,0.319754,0,9,0,0.01179
726853842294456320,726853842294456320,,81,4,85,81,4,85,8,0.223404,0.240193,0.000193,18,0.033204,0
112832545,112832545,,155,0,155,155,0,155,0,0,0,0,15,0.050286,0
3345387454,3345387454,,87,0,87,88,0,88,0,0,0,0,21,0.02964,0
8873182,8873182,,152,0,152,174,0,174,0,0,0,0,14,0.051811,0
2925822574,2925822574,,0,15,15,0,19,19,9,0.288678,0.334854,0,15,0,0.055468
2873377521,2873377521,,23,2,25,25,2,27,10,0.209324,0.230221,0.000558,15,0.012283,0
1400854572667703296,1400854572667703296,,5,8,13,5,9,14,10,0.224477,0.272684,0.000016,9,0.005143,0.004852
1325530241582960640,1325530241582960640,,15,0,15,15,0,15,0,0,0,0,15,0.007797,0
444121705,444121705,,11,29,40,11,29,40,8,0.281738,0.316281,0.000387,18,0.003959,0.002228
3025434267,3025434267,,1,19,20,1,19,20,6,0.3287,0.354782,0.000003,37,0.00162,0.004838
475234937,475234937,,103,206,309,115,219,334,7,0.370061,0.45453,0.002314,13,0.073468,0.022278
953310000,953310000,,10,0,10,11,0,11,0,0,0,0,15,0.003714,0
264950445,264950445,,0,1,1,0,1,1,1,1,1,0,21,0,0.000001
1570357357,1570357357,,0,1,1,0,1,1,1,1,1,0,21,0,0.000001
1436291445854457856,1436291445854457856,,0,1,1,0,1,1,1,1,1,0,9,0,0.000767
1400705294028742656,1400705294028742656,,0,1,1,0,1,1,1,1,1,0,21,0,0.000001
1427553158910390272,1427553158910390272,,0,5,5,0,5,5,10,0.222248,0.256619,0,13,0,0.022453
4860308297,4860308297,,3,4,7,3,4,7,9,0.258176,0.300527,0.000089,13,0.001256,0.023428
3077196184,3077196184,,0,2,2,0,2,2,2,0.75,0.833333,0,9,0,0.001715
3155682418,3155682418,,104,1,105,104,1,105,1,1,1,0.000002,21,0.032475,0.000866
1338614814,1338614814,,0,6,6,0,6,6,9,0.266213,0.306933,0,9,0,0.01421
1446500137602322432,1446500137602322432,,1,27,28,1,33,34,8,0.289515,0.321227,0.000012,9,0.000415,0.037876
710858753,710858753,,0,1,1,0,1,1,1,1,1,0,28,0,0.000022
896048840947765248,896048840947765248,,0,2,2,0,2,2,9,0.247378,0.279309,0,5,0,0.021721
917720230469750784,917720230469750784,,0,1,1,0,1,1,1,1,1,0,28,0,0.000022
1147682717888405504,1147682717888405504,,0,1,1,0,1,1,1,1,1,0,21,0,0.000001
1176925574,1176925574,,0,7,7,0,7,7,9,0.262889,0.301499,0,9,0,0.029902
720973914680201216,720973914680201216,,0,1,1,0,1,1,1,1,1,0,21,0,0.000001
447383139,447383139,,0,3,3,0,3,3,9,0.263086,0.308228,0,9,0,0.006585
1244210036,1244210036,,0,1,1,0,1,1,1,1,1,0,28,0,0.000022
2156336219,2156336219,,0,2,2,0,2,2,5,0.450575,0.473129,0,28,0,0.000068
523682869,523682869,,0,1,1,0,1,1,1,1,1,0,9,0,0.000767
2363018685,2363018685,,0,6,6,0,6,6,7,0.308556,0.349259,0,9,0,0.030798
923171889891209216,923171889891209216,,69,25,94,74,25,99,3,0.852941,0.925287,0.000436,14,0.034303,0.000047
1422100694266482688,1422100694266482688,,0,6,6,0,9,9,9,0.238626,0.28232,0,9,0,0.024688
1156611540,1156611540,,4,3,7,6,5,11,3,0.555556,0.633333,0.000001,9,0.000723,0.000001
2813435920,2813435920,,0,2,2,0,2,2,2,0.75,0.833333,0,21,0,0.000949
1320296479437836288,1320296479437836288,,0,6,6,0,7,7,9,0.267205,0.314725,0,15,0,0.007961
1174514317238112256,1174514317238112256,,23,0,23,23,0,23,0,0,0,0,15,0.010101,0
884095964730019840,884095964730019840,,0,1,1,0,1,1,1,1,1,0,21,0,0.000001
1551199729,1551199729,,0,0,0,0,0,0,0,0,0,0,16,0,0
581264884,581264884,,0,1,1,0,1,1,1,1,1,0,21,0,0.000001
1422293478541860864,1422293478541860864,,0,4,4,0,4,4,9,0.226759,0.248592,0,15,0,0.00721
448335186,448335186,,11,12,23,11,14,25,3,0.627907,0.716049,0.000035,15,0.00401,0.039241
1244762162746269696,1244762162746269696,,0,1,1,0,1,1,1,1,1,0,21,0,0.000001
755367370378604544,755367370378604544,,0,1,1,0,1,1,1,1,1,0,21,0,0.000001
1372438260568489984,1372438260568489984,,0,1,1,0,1,1,1,1,1,0,21,0,0.000001
462861866,462861866,,0,1,1,0,1,1,1,1,1,0,28,0,0.000022
397059204,397059204,,0,6,6,0,6,6,9,0.253335,0.291316,0,9,0,0.023537
842150238479634432,842150238479634432,,1,1,2,1,1,2,1,1,1,0,9,0.000688,0
872125071955030016,872125071955030016,,0,1,1,0,1,1,1,1,1,0,28,0,0.000022
1320285580975104000,1320285580975104000,,0,1,1,0,1,1,1,1,1,0,21,0,0.000001
892482377590636544,892482377590636544,,0,21,21,0,24,24,9,0.245925,0.294823,0,18,0,0.011835
2343158218,2343158218,,9,1,10,9,1,10,3,0.5,0.583333,0.000002,15,0.002383,0
1351442367644110848,1351442367644110848,,4,9,13,4,14,18,10,0.193388,0.216019,0.000039,206,0.001817,0.020979
875178422,875178422,,64,31,95,68,35,103,8,0.263876,0.293116,0.00176,18,0.025352,0.000716
1449282200030126080,1449282200030126080,,2,2,4,2,3,5,9,0.208979,0.222395,0.000002,18,0.000525,0.000741
1417238454560337920,1417238454560337920,,5,3,8,5,3,8,1,1,1,0.000005,15,0.00186,0
2832708639,2832708639,,14,0,14,14,0,14,0,0,0,0,57,0.0028,0
1196006918080417792,1196006918080417792,,4,3,7,4,3,7,8,0.239816,0.257834,0.000073,18,0.00254,0.000025
56957289,56957289,,2,3,5,2,5,7,3,0.529412,0.62963,0,110,0.000346,0.017963
2902258413,2902258413,,1,0,1,1,0,1,0,0,0,0,18,0.000346,0
1185613412,1185613412,,9,21,30,9,21,30,7,0.307134,0.327043,0.000072,9,0.005213,0.000135
3244161467,3244161467,,1,6,7,1,6,7,8,0.215197,0.230584,0.000005,15,0.000346,0.005663
1385612470182715392,1385612470182715392,,28,7,35,34,8,42,2,0.888889,0.9375,0.000063,15,0.011909,0
1434532915417919488,1434532915417919488,,5,28,33,6,32,38,10,0.208628,0.247183,0.000066,18,0.002879,0.01851
984895994755211264,984895994755211264,,8,1,9,8,1,9,1,1,1,0.00001,18,0.00331,0
1620724477,1620724477,,2,0,2,2,0,2,0,0,0,0,18,0.000346,0
71593119,71593119,,0,1,1,0,1,1,10,0.201268,0.216669,0,15,0,0
2270632844,2270632844,,1,2,3,1,2,3,9,0.251897,0.284672,0.000046,15,0,0.001178
1359744412704735232,1359744412704735232,,0,1,1,0,1,1,2,0.666667,0.75,0,21,0,0.000611
1401072119568650240,1401072119568650240,,0,3,3,0,3,3,5,0.435583,0.473474,0,21,0,0.003067
353811477,353811477,,0,1,1,0,1,1,1,1,1,0,28,0,0.000022
1138777682248982528,1138777682248982528,,0,10,10,0,11,11,9,0.267785,0.309281,0,13,0,0.02502
1448727801411026944,1448727801411026944,,1,0,1,1,0,1,0,0,0,0,13,0.000731,0
1207268171675324416,1207268171675324416,,26,4,30,28,4,32,2,0.7,0.785714,0.000064,18,0.010542,0
25676606,25676606,,13,18,31,16,27,43,3,0.702703,0.826923,0.000211,14,0.004689,0.000016
1025345033384411136,1025345033384411136,,0,17,17,0,18,18,9,0.300598,0.367255,0,13,0,0.062548
1446168777247399936,1446168777247399936,,5,1,6,5,1,6,6,0.390411,0.429474,0.000009,13,0.004068,0.00415
1431896816333754368,1431896816333754368,,7,6,13,7,7,14,2,0.8,0.875,0.000022,206,0.004059,0.000004
1154012367405178880,1154012367405178880,,58,0,58,58,0,58,0,0,0,0,9,0.032274,0
2264348977,2264348977,,9,4,13,9,4,13,7,0.286517,0.308396,0.000034,13,0.00645,0.01797
1138820269232013312,1138820269232013312,,5,0,5,5,0,5,0,0,0,0,13,0.002385,0
150357753,150357753,,97,0,97,98,0,98,0,0,0,0,25,0.021235,0
3145732173,3145732173,,0,3,3,0,3,3,9,0.217798,0.231347,0,5,0,0.038766
1433774196476334080,1433774196476334080,,0,1,1,0,1,1,1,1,1,0,9,0,0.000767
1121853269989634048,1121853269989634048,,0,1,1,0,1,1,1,1,1,0,28,0,0.000022
583751810,583751810,,0,1,1,0,1,1,1,1,1,0,28,0,0.000022
1125321094074970112,1125321094074970112,,0,1,1,0,1,1,2,0.666667,0.75,0,21,0,0.000611
1130994566100922368,1130994566100922368,,0,1,1,0,1,1,1,1,1,0,28,0,0.000022
1074611793920778240,1074611793920778240,,0,1,1,0,1,1,1,1,1,0,21,0,0.000001
279945959,279945959,,0,1,1,0,1,1,1,1,1,0,28,0,0.000022
1286536874,1286536874,,0,1,1,0,1,1,1,1,1,0,21,0,0.000001
1214443535476445184,1214443535476445184,,0,1,1,0,1,1,1,1,1,0,9,0,0.000767
2475753598,2475753598,,0,2,2,0,2,2,5,0.450575,0.473129,0,28,0,0.000068
1277122314933583872,1277122314933583872,,0,1,1,0,1,1,1,1,1,0,21,0,0.000001
1031091390,1031091390,,0,2,2,0,2,2,5,0.429448,0.463571,0,9,0,0.002357
1325385755959697408,1325385755959697408,,0,1,1,0,1,1,1,1,1,0,21,0,0.000001
980716740073189376,980716740073189376,,0,1,1,0,1,1,1,1,1,0,21,0,0.000001
375544141,375544141,,0,3,3,0,3,3,6,0.392318,0.4338,0,9,0,0.005537
2594940466,2594940466,,0,2,2,0,2,2,2,0.625,0.7,0,18,0,0.000791
1006510829649518592,1006510829649518592,,2,3,5,3,3,6,1,1,1,0,18,0.000843,0.024192
610172744,610172744,,0,2,2,0,2,2,6,0.391245,0.431469,0,9,0,0.004916
1345486989164994560,1345486989164994560,,0,3,3,0,3,3,2,0.8,0.875,0,9,0,0.018707
2995895663,2995895663,,1,0,1,1,0,1,0,0,0,0,9,0.000546,0
2889345052,2889345052,,0,6,6,0,6,6,7,0.320222,0.363491,0,9,0,0.009213
431031924,431031924,,1,0,1,1,0,1,0,0,0,0,9,0.000269,0
1008326401,1008326401,,1,0,1,1,0,1,0,0,0,0,9,0.000269,0
1427276891023626240,1427276891023626240,,0,7,7,0,7,7,9,0.268873,0.315923,0,9,0,0.03457
1414513564140904448,1414513564140904448,,0,5,5,0,5,5,9,0.219813,0.236401,0,37,0,0.005237
430882302,430882302,,5,0,5,6,0,6,0,0,0,0,9,0.001652,0
1414581209108205568,1414581209108205568,,1,1,2,1,1,2,1,1,1,0,37,0.000153,0.003445
1551211375,1551211375,,0,12,12,0,12,12,9,0.279926,0.33623,0,15,0,0.013099
438849246,438849246,,10,0,10,10,0,10,0,0,0,0,15,0.002388,0
433717645,433717645,,10,37,47,12,37,49,10,0.214509,0.258429,0.000262,19,0.005762,0.000323
1007741587995156480,1007741587995156480,,4,0,4,4,0,4,0,0,0,0,15,0.001624,0
975616683611181056,975616683611181056,,22,0,22,22,0,22,0,0,0,0,15,0.009562,0
929110006284406784,929110006284406784,,6,1,7,6,1,7,1,1,1,0.000005,15,0.003649,0
45295601,45295601,,1,1,2,2,1,3,1,1,1,0,9,0.001106,0.00007
928983246792208384,928983246792208384,,1,23,24,1,28,29,10,0.275631,0.34085,0.000008,18,0.001106,0.056485
1073339297355456512,1073339297355456512,,1,2,3,1,2,3,1,1,1,0,14,0.001106,0.001515
1227171998356443136,1227171998356443136,,1,3,4,1,4,5,10,0.204246,0.217551,0.000002,250,0.001106,0.00186
1430859677932326912,1430859677932326912,,1,2,3,1,2,3,8,0.303436,0.343252,0,9,0.001106,0.005733
1164832049963732992,1164832049963732992,,2,7,9,3,7,10,9,0.248206,0.281192,0.000017,9,0.001248,0.025616
1255863157521821696,1255863157521821696,,1,1,2,1,1,2,6,0.390411,0.429474,0.000001,9,0.001106,0.00415
1364131801619435520,1364131801619435520,,1,3,4,2,3,5,4,0.43617,0.481707,0,9,0.001106,0.000785
1436400225292259328,1436400225292259328,,2,4,6,2,4,6,9,0.257181,0.295416,0.000015,9,0.001116,0.009485
1389495200607883264,1389495200607883264,,2,6,8,4,6,10,7,0.331363,0.36772,0.000004,9,0.001182,0.032001
111966918,111966918,,3,3,6,3,3,6,8,0.24005,0.255554,0.000058,9,0.00214,0.018439
1227606981076291584,1227606981076291584,,1,5,6,1,5,6,3,0.666667,0.791667,0,5,0.001106,0.001533
1312802310830125056,1312802310830125056,,1,10,11,1,10,11,9,0.268993,0.3132,0.000008,13,0.001106,0.032485
627571631,627571631,,1,2,3,1,2,3,3,0.555556,0.666667,0,13,0.001106,0.018008
1432941587324092416,1432941587324092416,,2,15,17,2,20,22,9,0.213913,0.233865,0.000012,18,0.001116,0.021058
1295324221762142208,1295324221762142208,,2,7,9,3,8,11,11,0.195749,0.253295,0.000034,9,0.001833,0.048735
2162459239,2162459239,,2,5,7,2,5,7,2,0.727273,0.8125,0.000006,5,0.001631,0.020763
792731002900709376,792731002900709376,,24,16,40,25,18,43,3,0.651163,0.767857,0.000159,25,0.01267,0.018176
555997804,555997804,,0,1,1,0,1,1,1,1,1,0,28,0,0.000022
2902809855,2902809855,,0,2,2,0,2,2,2,0.6,0.666667,0,57,0,0.000857
1202683777530634240,1202683777530634240,,20,3,23,20,6,26,1,1,1,0.000054,57,0.008407,0
2436207123,2436207123,,0,7,7,0,8,8,9,0.279666,0.336316,0,15,0,0.012927
1613853324,1613853324,,5,10,15,5,10,15,7,0.290061,0.310761,0.000029,15,0.001584,0.000094
1182256918712205312,1182256918712205312,,1,0,1,1,0,1,0,0,0,0,15,0.000378,0
904438692,904438692,,0,1,1,0,1,1,1,1,1,0,9,0,0.000767
2240528067,2240528067,,0,2,2,0,2,2,8,0.303468,0.34324,0,9,0,0.005557
458729603,458729603,,0,3,3,0,3,3,6,0.392183,0.433219,0,9,0,0.009725
502018244,502018244,,0,8,8,0,8,8,9,0.27333,0.324972,0,9,0,0.015473
1420319969733234688,1420319969733234688,,1,6,7,1,8,9,7,0.285435,0.31091,0,9,0.000452,0
210410386,210410386,,0,1,1,0,1,1,2,0.666667,0.75,0,21,0,0.000611
1276488118548541440,1276488118548541440,,0,4,4,0,4,4,2,0.833333,0.9,0,28,0,0.000002
1231894919268196352,1231894919268196352,,4,0,4,4,0,4,0,0,0,0,28,0.000003,0
1392102531485085696,1392102531485085696,,1,0,1,1,0,1,0,0,0,0,28,0,0
425039950,425039950,,22,1,23,22,1,23,1,1,1,0.000003,33,0.000004,0.000054
14227296,14227296,,65,0,65,65,0,65,0,0,0,0,28,0.000052,0
1321173403429150720,1321173403429150720,,0,2,2,0,2,2,3,0.514286,0.546296,0,28,0,0.000023
1052650359217360896,1052650359217360896,,0,5,5,0,5,5,9,0.252487,0.289604,0,9,0,0.005489
2798863589,2798863589,,0,3,3,0,3,3,7,0.286495,0.312346,0,9,0,0.007721
1026475254577807360,1026475254577807360,,0,8,8,0,9,9,9,0.211852,0.230427,0,15,0,0.003152
2861015745,2861015745,,9,0,9,9,0,9,0,0,0,0,5,0.002116,0
2414900892,2414900892,,1,1,2,1,1,2,9,0.234728,0.252926,0.000002,15,0.000092,0.000002
738092501853216768,738092501853216768,,10,0,10,11,0,11,0,0,0,0,15,0.005138,0
969759516,969759516,,0,3,3,0,3,3,9,0.24747,0.279605,0,9,0,0.019719
1349697321576099840,1349697321576099840,,0,2,2,0,2,2,2,0.666667,0.75,0,21,0,0.021304
1262507047582564352,1262507047582564352,,0,1,1,0,1,1,2,0.666667,0.75,0,21,0,0.000611
1415258153508380672,1415258153508380672,,0,15,15,0,18,18,11,0.190529,0.229982,0,17,0,0.022209
490139250,490139250,,1,0,1,2,0,2,0,0,0,0,17,0.000649,0
123920914,123920914,,4,0,4,8,0,8,0,0,0,0,17,0.0013,0
150725695,150725695,,2,5,7,4,12,16,1,1,1,0,17,0.000649,0.000009
1092025800,1092025800,,12,1,13,12,1,13,9,0.183116,0.192791,0.000015,14,0.003953,0.00097
1423166823684509696,1423166823684509696,,1,7,8,1,9,10,7,0.351759,0.388872,0.000008,15,0.000649,0.02968
1035376896,1035376896,,1,1,2,1,1,2,1,1,1,0,17,0.000649,0
744659342738210816,744659342738210816,,1,0,1,1,0,1,0,0,0,0,17,0.000649,0
2571088997,2571088997,,22,0,22,23,0,23,0,0,0,0,15,0.00993,0
374385397,374385397,,21,0,21,21,0,21,0,0,0,0,17,0.001863,0
945667763661570048,945667763661570048,,0,3,3,0,3,3,9,0.252301,0.288958,0,9,0,0.00393
493833883,493833883,,0,1,1,0,1,1,1,1,1,0,9,0,0.000767
1042906497129361408,1042906497129361408,,0,11,11,0,15,15,9,0.303061,0.344259,0,14,0,0.031526
601894652,601894652,,1,2,3,1,2,3,9,0.213139,0.225189,0,13,0.000921,0.000021
1223200116670115840,1223200116670115840,,8,3,11,8,5,13,3,0.555556,0.633333,0.000111,14,0.00301,0.001523
319342552,319342552,,44,61,105,49,63,112,7,0.326103,0.368844,0.000684,14,0.018524,0.000383
1223954414807011328,1223954414807011328,,0,10,10,0,10,10,11,0.193323,0.231916,0,18,0,0.003782
11540552,11540552,,1,3,4,1,4,5,2,0.714286,0.8,0,13,0.00011,0.03865
1442432979922341888,1442432979922341888,,2,3,5,2,4,6,8,0.319314,0.362136,0.000014,18,0.00029,0.006942
1280203938994827264,1280203938994827264,,1,0,1,1,0,1,0,0,0,0,18,0.00011,0
849293424775897088,849293424775897088,,9,0,9,9,0,9,0,0,0,0,15,0.003238,0
1291283802648608768,1291283802648608768,,1,0,1,1,0,1,0,0,0,0,18,0.00011,0
1926324451,1926324451,,0,2,2,0,2,2,2,0.666667,0.75,0,21,0,0.021304
382539264,382539264,,0,3,3,0,3,3,9,0.2479,0.280165,0,21,0,0.001727
799007315034800128,799007315034800128,,0,6,6,0,6,6,9,0.260761,0.303567,0,15,0,0.025097
2771551873,2771551873,,0,2,2,0,2,2,2,0.75,0.833333,0,9,0,0.018691
695981551973179392,695981551973179392,,0,1,1,0,1,1,1,1,1,0,9,0,0.000767
1317903530217381888,1317903530217381888,,0,2,2,0,2,2,1,1,1,0,28,0,0.000022
1375249800904519680,1375249800904519680,,1,0,1,1,0,1,0,0,0,0,28,0.000001,0
48142375,48142375,,0,3,3,0,3,3,6,0.392613,0.43403,0,9,0,0.025609
397914712,397914712,,0,1,1,0,1,1,1,1,1,0,9,0,0.000767
416583838,416583838,,0,12,12,0,13,13,9,0.240411,0.267629,0,21,0,0.003791
920277002858500096,920277002858500096,,5,1,6,8,2,10,1,1,1,0.000018,21,0.000376,0
507846462,507846462,,1,0,1,1,0,1,0,0,0,0,21,0.000111,0
1445106068116447232,1445106068116447232,,1,2,3,1,2,3,7,0.282203,0.300647,0,21,0.000111,0
1029820177,1029820177,,2,0,2,2,0,2,0,0,0,0,206,0.000856,0
1398742674031747072,1398742674031747072,,3,9,12,3,10,13,7,0.285954,0.323981,0.00004,15,0.000727,0.027609
459759337,459759337,,0,3,3,0,3,3,11,0.172797,0.19286,0,18,0,0.021543
824021536747225088,824021536747225088,,0,1,1,0,1,1,1,1,1,0,9,0,0.000767
1032209514513293312,1032209514513293312,,1,68,69,1,275,276,8,0.283971,0.328837,0.000011,19,0.000949,0.028082
1061995816708124672,1061995816708124672,,5,0,5,5,0,5,0,0,0,0,13,0.005027,0
2525778087,2525778087,,4,3,7,6,4,10,2,0.714286,0.8,0.000003,13,0.002415,0.03865
1239969355280105472,1239969355280105472,,0,3,3,0,3,3,2,0.714286,0.8,0,9,0,0.019302
776505522841391104,776505522841391104,,0,3,3,0,3,3,9,0.219895,0.236433,0,18,0,0.002222
1432801222898114560,1432801222898114560,,0,4,4,0,4,4,2,0.75,0.833333,0,9,0,0.040897
1349467232,1349467232,,0,5,5,0,5,5,8,0.259992,0.292256,0,15,0,0.010526
57358236,57358236,,0,3,3,0,3,3,7,0.29013,0.311234,0,18,0,0.005883
452013510,452013510,,0,4,4,0,5,5,9,0.251553,0.287349,0,14,0,0.002706
588854129,588854129,,0,1,1,0,1,1,2,0.666667,0.75,0,21,0,0.000611
1288901307093450752,1288901307093450752,,0,6,6,0,6,6,8,0.269656,0.312919,0,18,0,0.012742
1506815232,1506815232,,0,1,1,0,1,1,1,1,1,0,9,0,0.000767
877853257783287808,877853257783287808,,0,2,2,0,2,2,6,0.391542,0.431707,0,21,0,0.004761
1224372342308077568,1224372342308077568,,0,1,1,0,1,1,9,0.217683,0.230741,0,5,0,0.000149
365633533,365633533,,0,6,6,0,6,6,9,0.225981,0.248865,0,37,0,0.001185
11952552,11952552,,2,1,3,2,1,3,3,0.5,0.611111,0,37,0.000053,0
1112793000059527168,1112793000059527168,,9,4,13,9,10,19,2,0.833333,0.9,0.000058,21,0.002929,0.00156
268481482,268481482,,3,0,3,3,0,3,0,0,0,0,37,0.000036,0
4019910797,4019910797,,0,3,3,0,3,3,8,0.247004,0.263534,0,13,0,0.000613
753694909,753694909,,0,2,2,0,2,2,7,0.273551,0.306701,0,18,0,0.002154
1861376149,1861376149,,2,2,4,2,4,6,3,0.5,0.583333,0,18,0.00065,0.000001
994221768402526208,994221768402526208,,0,1,1,0,1,1,9,0.247311,0.279001,0,15,0,0.001028
1100725721465532416,1100725721465532416,,0,3,3,0,3,3,8,0.270926,0.296867,0,18,0,0.020089
368241794,368241794,,1,1,2,1,1,2,2,0.666667,0.75,0,37,0,0.020692
1079800282832343040,1079800282832343040,,0,1,1,0,1,1,1,1,1,0,28,0,0
1401979774868799488,1401979774868799488,,0,3,3,0,3,3,9,0.226858,0.250853,0,18,0,0.001208
443587070,443587070,,1,0,1,1,0,1,0,0,0,0,18,0.000035,0
4640492355,4640492355,,0,1,1,0,1,1,1,1,1,0,28,0,0
890952915539636224,890952915539636224,,0,2,2,0,3,3,7,0.282203,0.300647,0,13,0,0.000119
1325065403748511744,1325065403748511744,,1,0,1,2,0,2,0,0,0,0,13,0.000003,0
377430097,377430097,,0,12,12,0,12,12,8,0.26792,0.299554,0,18,0,0.049979
367045287,367045287,,31,0,31,31,0,31,0,0,0,0,28,0.00204,0
1191655318612254720,1191655318612254720,,4,2,6,4,2,6,1,1,1,0.000005,18,0.002419,0
3305939879,3305939879,,2,2,4,2,2,4,8,0.270403,0.29586,0.000039,13,0.000728,0.02007
391359161,391359161,,1,0,1,1,0,1,0,0,0,0,13,0.000001,0
2585782921,2585782921,,2,0,2,2,0,2,0,0,0,0,25,0.00001,0
497885623,497885623,,1,6,7,1,7,8,9,0.268587,0.315302,0.00001,13,0.00001,0.050758
946357302835273728,946357302835273728,,1,1,2,1,1,2,1,1,1,0,5,0.00001,0.003445
436857041,436857041,,1,0,1,1,0,1,0,0,0,0,5,0.00001,0
1242089940143538176,1242089940143538176,,1,11,12,1,14,15,7,0.323067,0.369623,0.000063,14,0.00001,0.051037
2153153533,2153153533,,1,4,5,1,4,5,7,0.285714,0.319409,0.000006,14,0.00001,0.022224
1449787076686254080,1449787076686254080,,1,0,1,1,0,1,0,0,0,0,5,0.00001,0
32596998,32596998,,1,4,5,1,4,5,9,0.252325,0.286263,0.000006,9,0.00001,0.027142
1385324301478469632,1385324301478469632,,1,0,1,1,0,1,0,0,0,0,5,0.00001,0
1398989037457846272,1398989037457846272,,1,0,1,1,0,1,0,0,0,0,5,0.00001,0
290963421,290963421,,1,1,2,1,1,2,9,0.247311,0.279001,0.000006,5,0.00001,0.001028
589858943,589858943,,1,0,1,1,0,1,0,0,0,0,5,0.00001,0
1262200130,1262200130,,1,9,10,1,12,13,9,0.270731,0.318245,0.000014,13,0.00001,0.027689
2502131693,2502131693,,1,1,2,1,1,2,9,0.247311,0.279001,0.000006,5,0.00001,0.001028
4735121836,4735121836,,1,0,1,1,0,1,0,0,0,0,5,0.00001,0
1103092730690002944,1103092730690002944,,1,0,1,1,0,1,0,0,0,0,5,0.00001,0
3047103415,3047103415,,1,8,9,1,9,10,9,0.266739,0.311275,0.000018,15,0.00001,0.049285
1428603283531309056,1428603283531309056,,1,5,6,1,7,8,1,1,1,0.000001,15,0.00001,0.001132
833443843664117760,833443843664117760,,1,4,5,2,6,8,2,0.75,0.833333,0,13,0.00001,0.039814
1271172173718343680,1271172173718343680,,1,0,1,1,0,1,0,0,0,0,5,0.00001,0
162275518,162275518,,1,6,7,1,6,7,6,0.36422,0.407976,0.000014,9,0.00001,0.015544
1258867179191259136,1258867179191259136,,1,4,5,1,4,5,8,0.306989,0.349012,0.000004,9,0.00001,0.023928
743858514,743858514,,1,1,2,1,1,2,9,0.247311,0.279001,0.000006,5,0.00001,0.001028
1396364775295234048,1396364775295234048,,1,0,1,1,0,1,0,0,0,0,5,0.00001,0
208831904,208831904,,1,2,3,1,2,3,9,0.247378,0.279309,0.000006,5,0.00001,0.021721
1145087891141476352,1145087891141476352,,1,1,2,1,1,2,2,0.666667,0.75,0,5,0.00001,0.020692
518486571,518486571,,1,6,7,1,8,9,9,0.219833,0.243664,0.000005,9,0.00001,0.00069
4853695089,4853695089,,1,5,6,1,5,6,9,0.247672,0.280249,0.000007,15,0.00001,0.043232
810235254870937600,810235254870937600,,1,3,4,1,3,4,8,0.319302,0.362161,0.000007,25,0.00001,0.007557
1269242298119991296,1269242298119991296,,1,1,2,1,1,2,1,1,1,0,5,0.00001,0.001469
1216708048409985024,1216708048409985024,,1,1,2,1,1,2,3,0.5,0.611111,0,5,0.00001,0
993183659292348416,993183659292348416,,1,0,1,1,0,1,0,0,0,0,5,0.00001,0
585883841,585883841,,1,6,7,1,6,7,9,0.261477,0.304748,0.000015,18,0.00001,0.004918
264781838,264781838,,1,1,2,1,1,2,1,1,1,0,206,0.00001,0.000004
1344383673261584384,1344383673261584384,,1,1,2,1,1,2,1,1,1,0,15,0.00001,0.000228
963938472,963938472,,2,0,2,3,0,3,0,0,0,0,25,0.000011,0
1427941575309598720,1427941575309598720,,1,0,1,1,0,1,0,0,0,0,5,0.00001,0
1361005604119187456,1361005604119187456,,1,9,10,1,11,12,6,0.380065,0.422141,0.000018,13,0.00001,0.055359
913718930404990976,913718930404990976,,1,2,3,1,2,3,8,0.270467,0.296004,0.000003,5,0.00001,0.022838
1241719432625471488,1241719432625471488,,1,0,1,1,0,1,0,0,0,0,5,0.00001,0
1324997161667485696,1324997161667485696,,1,2,3,1,2,3,3,0.52381,0.575758,0.000001,15,0.00001,0.000348
498843180,498843180,,1,4,5,1,4,5,9,0.209599,0.22438,0.000002,14,0.00001,0.024901
1420711554270511104,1420711554270511104,,2,20,22,2,29,31,9,0.301977,0.365695,0.00007,9,0.000826,0.040606
1445102415150305280,1445102415150305280,,1,0,1,1,0,1,0,0,0,0,5,0.00001,0
1353030410796720128,1353030410796720128,,1,2,3,1,3,4,9,0.247401,0.279339,0.000006,13,0.00001,0.018953
527777851,527777851,,1,1,2,1,1,2,2,0.666667,0.75,0,5,0.00001,0.020692
136767243,136767243,,1,0,1,1,0,1,0,0,0,0,5,0.00001,0
1448730735536451584,1448730735536451584,,1,1,2,1,1,2,10,0.155218,0.162578,0,14,0.00001,0.000115
1380302501812047872,1380302501812047872,,1,2,3,1,2,3,8,0.303546,0.34345,0.000003,5,0.00001,0.025483
3163728767,3163728767,,2,2,4,4,2,6,8,0.263189,0.281919,0.000005,19,0.00083,0.00535
936010797217656832,936010797217656832,,1,2,3,1,2,3,9,0.237551,0.277265,0.000004,5,0.00001,0.005531
106378808,106378808,,1,1,2,1,1,2,8,0.303216,0.342457,0.000003,5,0.00001,0.00479
3432525375,3432525375,,1,3,4,1,3,4,9,0.247447,0.279574,0.000007,5,0.00001,0.021739
1251822820633595904,1251822820633595904,,1,3,4,1,3,4,2,0.8,0.875,0,9,0.00001,0.020381
1001748711729434624,1001748711729434624,,1,1,2,1,1,2,2,0.666667,0.75,0,5,0.00001,0.020692
959539835999522816,959539835999522816,,1,1,2,1,1,2,2,0.666667,0.75,0,5,0.00001,0.020692
1032615842,1032615842,,1,10,11,1,12,13,10,0.251425,0.320657,0.000018,110,0.00001,0.032889
1449324167862575104,1449324167862575104,,1,0,1,1,0,1,0,0,0,0,5,0.00001,0
970017772406296576,970017772406296576,,1,2,3,1,2,3,10,0.209199,0.235358,0.000004,9,0.00001,0.001295
1408365643490119680,1408365643490119680,,1,4,5,1,6,7,9,0.253479,0.288491,0.000009,15,0.00001,0.006845
2615476385,2615476385,,0,1,1,0,1,1,2,0.666667,0.75,0,21,0,0.000611
1043108743112806400,1043108743112806400,,3,1,4,5,2,7,1,1,1,0,18,0.000007,0
1446245624,1446245624,,1,6,7,1,7,8,7,0.277678,0.316672,0.000003,9,0.000007,0.020388
2749292998,2749292998,,2,7,9,2,8,10,6,0.379838,0.422966,0.000014,13,0.000548,0.054144
3318877703,3318877703,,2,2,4,2,2,4,11,0.18545,0.215744,0.000016,18,0.000083,0.000709
2256287230,2256287230,,2,3,5,2,3,5,8,0.246728,0.262882,0.000007,15,0.000083,0.0007
430544226,430544226,,3,6,9,3,7,10,7,0.274522,0.312777,0.000054,13,0.000224,0.043216
1279126399295651840,1279126399295651840,,1,1,2,1,1,2,2,0.666667,0.75,0,18,0.000007,0.017924
1184807557380091904,1184807557380091904,,1,0,1,1,0,1,0,0,0,0,18,0.000007,0
2674312609,2674312609,,1,1,2,1,1,2,6,0.390411,0.429474,0.000001,18,0.000007,0.00415
3372869746,3372869746,,2,5,7,2,6,8,6,0.359161,0.395252,0.000009,14,0.000083,0.031172
799651181257785344,799651181257785344,,1,0,1,1,0,1,0,0,0,0,18,0.000007,0
754738337445998592,754738337445998592,,1,3,4,1,3,4,7,0.360317,0.400028,0.00004,18,0.000007,0.006368
471995227,471995227,,1,4,5,1,4,5,6,0.393243,0.43551,0.000001,5,0.000007,0.02712
2713176561,2713176561,,2,10,12,2,14,16,9,0.274683,0.341583,0.00004,13,0.000083,0.033273
1345129094619537408,1345129094619537408,,1,1,2,1,1,2,2,0.666667,0.75,0,18,0.000007,0.020692
3092475844,3092475844,,1,1,2,1,1,2,1,1,1,0,18,0.000007,0.003445
1037076323599114240,1037076323599114240,,3,9,12,3,10,13,8,0.310459,0.355207,0.000054,13,0.000659,0.027502
139715784,139715784,,2,0,2,2,0,2,0,0,0,0,18,0.000072,0
1368851155074318336,1368851155074318336,,2,5,7,2,5,7,6,0.394231,0.438095,0.000017,5,0.000217,0.046457
821429403137740800,821429403137740800,,1,0,1,1,0,1,0,0,0,0,18,0.000007,0
1390653288136290304,1390653288136290304,,2,15,17,2,17,19,9,0.264443,0.309082,0.000612,13,0.000007,0.048859
1243305305162866688,1243305305162866688,,1,0,1,1,0,1,0,0,0,0,18,0.000007,0
1183339205700866048,1183339205700866048,,1,0,1,1,0,1,0,0,0,0,18,0.000007,0
531198622,531198622,,1,0,1,1,0,1,0,0,0,0,18,0.000007,0
110372659,110372659,,1,1,2,1,1,2,1,1,1,0,13,0.000007,0.000102
2227488127,2227488127,,1,3,4,1,3,4,7,0.285714,0.3072,0,15,0.000007,0.005864
391225628,391225628,,3,2,5,3,2,5,8,0.22973,0.246724,0.000008,18,0.000963,0.001058
1312086658481901568,1312086658481901568,,2,1,3,2,1,3,1,1,1,0,18,0.000658,0.001469
995623958,995623958,,2,3,5,2,4,6,7,0.306306,0.336183,0.000032,13,0.000015,0.024323
1198658049688424448,1198658049688424448,,2,1,3,2,1,3,1,1,1,0,37,0.000008,0.000042
1389814780349853696,1389814780349853696,,2,11,13,2,12,14,7,0.320378,0.36542,0.00002,15,0.000083,0.035422
1225034977,1225034977,,2,3,5,2,4,6,5,0.442308,0.478744,0.000017,13,0.000217,0.020983
3366460893,3366460893,,1,7,8,1,7,8,9,0.224503,0.258129,0.000003,15,0.000007,0.028956
588539018,588539018,,2,0,2,2,0,2,0,0,0,0,18,0.000083,0
2173750477,2173750477,,2,0,2,2,0,2,0,0,0,0,18,0.000217,0
1430063748082020352,1430063748082020352,,2,5,7,2,5,7,6,0.398123,0.441021,0.000043,9,0.000217,0.008364
3179856502,3179856502,,1,2,3,1,2,3,2,0.75,0.833333,0,15,0.000007,0.000658
401507232,401507232,,2,1,3,2,1,3,7,0.283203,0.300698,0,18,0.000734,0.004809
2805323313,2805323313,,4,1,5,4,2,6,2,0.6,0.666667,0.000002,15,0.002919,0.000016
1201160808249647104,1201160808249647104,,0,6,6,0,6,6,9,0.22631,0.252291,0,21,0,0.021337
1151954305659936768,1151954305659936768,,8,1,9,8,1,9,1,1,1,0,21,0.002399,0.001513
445201884,445201884,,22,1,23,25,2,27,1,1,1,0.000018,21,0.003813,0
1446857524045561856,1446857524045561856,,0,5,5,0,5,5,10,0.216455,0.251872,0,13,0,0.043555
396571033,396571033,,1,4,5,1,4,5,9,0.240795,0.268649,0.00003,13,0.001272,0.002929
1469698524,1469698524,,9,0,9,9,0,9,0,0,0,0,18,0.00378,0
74753692,74753692,,0,2,2,0,2,2,9,0.226578,0.249946,0,13,0,0.000237
1448554649552920576,1448554649552920576,,1,0,1,1,0,1,0,0,0,0,13,0.000007,0
710107186756788224,710107186756788224,,0,1,1,0,1,1,3,0.416667,0.5,0,25,0,0
1184189129208324096,1184189129208324096,,1,1,2,1,2,3,2,0.571429,0.625,0,25,0,0.000036
1347607267546456064,1347607267546456064,,3,2,5,4,5,9,3,0.5,0.583333,0.000016,18,0.003904,0.000001
1004781943,1004781943,,1,0,1,1,0,1,0,0,0,0,18,0.00165,0
1276814434124660736,1276814434124660736,,6,0,6,6,0,6,0,0,0,0,206,0.002309,0
1277556633430827008,1277556633430827008,,5,10,15,7,12,19,1,1,1,0.000056,18,0.002251,0
903357817020706816,903357817020706816,,2,6,8,2,7,9,8,0.254119,0.279564,0.000043,110,0.001726,0.005636
972415730,972415730,,25,0,25,25,0,25,0,0,0,0,28,0.001697,0
958687477,958687477,,8,0,8,8,0,8,0,0,0,0,18,0.003137,0
3096871079,3096871079,,47,0,47,47,0,47,0,0,0,0,15,0.013336,0
229160327,229160327,,0,11,11,0,12,12,9,0.279992,0.337239,0,13,0,0.052496
1372897890234949632,1372897890234949632,,12,0,12,12,0,12,0,0,0,0,15,0.004402,0
1272821807658172416,1272821807658172416,,2,0,2,2,0,2,0,0,0,0,14,0.000044,0
1324253602471464960,1324253602471464960,,0,2,2,0,4,4,1,1,1,0,13,0,0.000045
1593078650,1593078650,,4,0,4,5,0,5,0,0,0,0,13,0.001551,0
1308848585300160512,1308848585300160512,,1,0,1,2,0,2,0,0,0,0,13,0.000001,0
2942085310,2942085310,,0,2,2,0,2,2,1,1,1,0,18,0,0.000022
2385306326,2385306326,,14,0,14,14,0,14,0,0,0,0,18,0.000002,0
1398738372575870976,1398738372575870976,,0,8,8,0,10,10,10,0.235637,0.289942,0,21,0,0.025666
372273460,372273460,,2,0,2,3,0,3,0,0,0,0,21,0.000778,0
399004979,399004979,,3,0,3,6,0,6,0,0,0,0,21,0.001882,0
141529750,141529750,,1,6,7,1,8,9,6,0.363244,0.407977,0.000002,13,0.00075,0.032317
1363158850040434688,1363158850040434688,,1,0,1,1,0,1,0,0,0,0,21,0.00075,0
884460743453798400,884460743453798400,,1,2,3,1,3,4,6,0.391484,0.431813,0.000002,13,0.00075,0.022074
1141045316449439744,1141045316449439744,,2,8,10,2,8,10,9,0.234779,0.269233,0.000069,206,0.001363,0.004367
1448718017534234624,1448718017534234624,,0,1,1,0,1,1,7,0.281496,0.298202,0,13,0,0.000119
1673451542,1673451542,,0,7,7,0,7,7,9,0.258052,0.300146,0,13,0,0.023978
970804857580990464,970804857580990464,,7,12,19,7,12,19,7,0.296296,0.331367,0.000069,18,0.003937,0.004954
1398627835280072704,1398627835280072704,,5,0,5,5,0,5,0,0,0,0,13,0.001049,0
1922823546,1922823546,,0,2,2,0,2,2,10,0.189001,0.201917,0,15,0,0.000002
1415963988568027136,1415963988568027136,,2,5,7,2,7,9,9,0.228042,0.252721,0.000058,13,0.000065,0.000253
1198355954678616064,1198355954678616064,,2,3,5,2,4,6,10,0.173016,0.18132,0.000028,15,0.000003,0.021102
1196180405621268480,1196180405621268480,,0,1,1,0,1,1,1,1,1,0,28,0,0.000022
3303206327,3303206327,,0,3,3,0,3,3,5,0.413043,0.501754,0,13,0,0.001022
1200818228777357312,1200818228777357312,,10,8,18,10,9,19,4,0.576923,0.727778,0.00003,13,0.003528,0.018068
1370078456,1370078456,,0,1,1,0,1,1,1,1,1,0,28,0,0
957072768,957072768,,1,4,5,1,5,6,9,0.259121,0.300294,0.000032,15,0.000086,0.021193
823975885963399168,823975885963399168,,2,33,35,2,37,39,10,0.229559,0.27425,0.000081,13,0.001359,0.000125
2308436372,2308436372,,0,2,2,0,2,2,5,0.450575,0.473129,0,28,0,0.000068
1329518175730491392,1329518175730491392,,0,1,1,0,1,1,2,0.666667,0.75,0,21,0,0.000611
862202945420611584,862202945420611584,,0,1,1,0,1,1,2,0.666667,0.75,0,21,0,0.000611
1349303685243932672,1349303685243932672,,11,0,11,12,0,12,0,0,0,0,14,0.002381,0
1055407818357030912,1055407818357030912,,1,0,1,1,0,1,0,0,0,0,14,0.001491,0
824730857466425344,824730857466425344,,8,2,10,8,3,11,2,0.75,0.833333,0.000001,5,0.00211,0.02071
16145985,16145985,,6,1,7,8,2,10,1,1,1,0.000001,15,0.003548,0
1185817803825319936,1185817803825319936,,0,2,2,0,2,2,2,0.75,0.833333,0,15,0,0.000766
2328604034,2328604034,,14,0,14,14,0,14,0,0,0,0,15,0.00531,0
1432078985412943872,1432078985412943872,,0,1,1,0,1,1,1,1,1,0,28,0,0.000022
10350822,10350822,,0,1,1,0,1,1,1,1,1,0,28,0,0.000022
397853516,397853516,,0,3,3,0,3,3,9,0.247424,0.279554,0,21,0,0.022587
1112062778242723840,1112062778242723840,,0,1,1,0,1,1,1,1,1,0,28,0,0.000022
370407019,370407019,,5,0,5,5,0,5,0,0,0,0,14,0.000651,0
2984387777,2984387777,,0,1,1,0,1,1,2,0.666667,0.75,0,21,0,0.000611
2397844595,2397844595,,0,5,5,0,6,6,7,0.254599,0.273665,0,28,0,0.000023
2644998883,2644998883,,15,23,38,18,23,41,6,0.326687,0.360955,0.000071,28,0.000018,0.000005
1230551046,1230551046,,8,8,16,8,8,16,2,0.833333,0.9,0.000074,28,0.000005,0
1421173038817681408,1421173038817681408,,0,1,1,0,1,1,1,1,1,0,28,0,0
1333794684737445888,1333794684737445888,,0,2,2,0,2,2,1,1,1,0,28,0,0.000022
1210948801575321600,1210948801575321600,,5,0,5,6,0,6,0,0,0,0,28,0.000002,0
1240239670442758144,1240239670442758144,,0,1,1,0,1,1,1,1,1,0,28,0,0.000022
1403783525434863616,1403783525434863616,,0,1,1,0,1,1,9,0.205166,0.21661,0,15,0,0.000162
1300529150848098304,1300529150848098304,,0,1,1,0,1,1,1,1,1,0,28,0,0.000022
2331718804,2331718804,,2,0,2,3,0,3,0,0,0,0,19,0.000822,0
51522357,51522357,,4,5,9,10,5,15,8,0.305225,0.346897,0.000081,19,0.001502,0.022868
431793661,431793661,,2,3,5,5,3,8,7,0.27582,0.311532,0.000094,19,0.000824,0.002287
1200452960305717248,1200452960305717248,,2,2,4,3,2,5,2,0.625,0.7,0,19,0.000842,0.020748
1120662112513265664,1120662112513265664,,2,2,4,3,2,5,2,0.625,0.7,0,19,0.000842,0.020748
1309482182075920384,1309482182075920384,,2,2,4,3,2,5,2,0.625,0.7,0,19,0.000842,0.020748
1444295878324408320,1444295878324408320,,2,1,3,2,1,3,7,0.272226,0.304285,0.000003,14,0.000896,0.002135
995657337393287168,995657337393287168,,1,4,5,1,4,5,7,0.294118,0.338694,0.000001,15,0.00082,0.024465
1215553344951017472,1215553344951017472,,1,0,1,1,0,1,0,0,0,0,19,0.00082,0
4331048541,4331048541,,1,0,1,1,0,1,0,0,0,0,19,0.00082,0
807095,807095,,2,0,2,168,0,168,0,0,0,0,19,0.000821,0
1243575912337113088,1243575912337113088,,1,0,1,2,0,2,0,0,0,0,19,0.00082,0
2189394718,2189394718,,1,1,2,3,1,4,11,0.173163,0.184811,0.000001,19,0.00082,0.000359
2568712240,2568712240,,1,4,5,3,4,7,4,0.44,0.502525,0,19,0.00082,0.000177
854240012149424128,854240012149424128,,2,3,5,6,3,9,12,0.164501,0.190845,0.000002,19,0.000896,0.000005
1368152558,1368152558,,4,4,8,4,4,8,11,0.206383,0.252707,0.000048,13,0.000827,0.002384
1415080568442826752,1415080568442826752,,1,1,2,1,1,2,2,0.666667,0.75,0,19,0.00082,0.020692
1337716736204943360,1337716736204943360,,3,24,27,3,29,32,10,0.274958,0.363254,0.00008,21,0.000898,0.038128
764201799217717248,764201799217717248,,6,8,14,7,8,15,8,0.241582,0.259435,0.000048,250,0.003335,0.018677
560353561,560353561,,2,1,3,2,1,3,1,1,1,0,15,0.000896,0.001469
1449500018981937152,1449500018981937152,,2,1,3,2,1,3,8,0.270277,0.295281,0.000005,13,0.000896,0.002146
1343937223947919360,1343937223947919360,,2,3,5,9,3,12,5,0.443038,0.479048,0.000004,19,0.000856,0.040207
2370797451,2370797451,,1,1,2,1,1,2,2,0.6,0.666667,0,19,0.00082,0.000056
1243233998509309952,1243233998509309952,,1,0,1,1,0,1,0,0,0,0,19,0.00082,0
605614784,605614784,,1,0,1,1,0,1,0,0,0,0,19,0.00082,0
1368001034166153216,1368001034166153216,,3,4,7,3,4,7,9,0.209622,0.224181,0.00002,110,0.000889,0.018697
561951458,561951458,,1,0,1,1,0,1,0,0,0,0,19,0.00082,0
765564104,765564104,,1,0,1,1,0,1,0,0,0,0,19,0.00082,0
321228288,321228288,,2,0,2,2,0,2,0,0,0,0,19,0.000842,0
1249822627700658176,1249822627700658176,,2,0,2,2,0,2,0,0,0,0,19,0.000842,0
331023751,331023751,,1,1,2,1,1,2,2,0.666667,0.75,0,19,0.00082,0.020692
1416071387295408128,1416071387295408128,,3,0,3,3,0,3,0,0,0,0,110,0.001115,0
1391766884052254720,1391766884052254720,,2,5,7,2,7,9,12,0.164579,0.19171,0.000005,19,0.000896,0.000061
1055863542023360512,1055863542023360512,,2,1,3,2,1,3,2,0.666667,0.75,0.000007,15,0.000824,0.000107
419768382,419768382,,1,0,1,1,0,1,0,0,0,0,19,0.00082,0
1543958582,1543958582,,1,0,1,1,0,1,0,0,0,0,19,0.00082,0
962670878,962670878,,1,0,1,1,0,1,0,0,0,0,19,0.00082,0
1250716136250970112,1250716136250970112,,1,2,3,1,2,3,3,0.482759,0.535714,0,19,0.00082,0.000152
961233370821914624,961233370821914624,,2,2,4,5,2,7,6,0.39498,0.434448,0.000148,250,0.000824,0.004154
2186512819,2186512819,,1,0,1,1,0,1,0,0,0,0,19,0.00082,0
920932298350039040,920932298350039040,,1,0,1,2,0,2,0,0,0,0,19,0.00082,0
2385799301,2385799301,,2,3,5,2,3,5,8,0.242232,0.257758,0.000032,18,0.000896,0.01916
70954365,70954365,,2,1,3,2,2,4,1,1,1,0,15,0.000864,0
2212765333,2212765333,,1,1,2,1,1,2,1,1,1,0,19,0.00082,0
1234458775,1234458775,,1,1,2,1,1,2,3,0.444444,0.541667,0,19,0.00082,0.000002
2300311050,2300311050,,1,0,1,1,0,1,0,0,0,0,19,0.00082,0
1007584526971924480,1007584526971924480,,1,2,3,1,2,3,2,0.666667,0.75,0,19,0.00082,0.000056
1321232532495544320,1321232532495544320,,1,1,2,2,1,3,1,1,1,0,19,0.00082,0
894084727061217280,894084727061217280,,1,0,1,1,0,1,0,0,0,0,19,0.00082,0
56512034,56512034,,1,0,1,1,0,1,0,0,0,0,19,0.00082,0
503135180,503135180,,1,0,1,1,0,1,0,0,0,0,19,0.00082,0
110460168,110460168,,1,3,4,1,3,4,8,0.226724,0.243626,0,9,0.00082,0.019097
2605826035,2605826035,,2,1,3,2,1,3,2,0.666667,0.75,0,13,0.001547,0.020692
3687608434,3687608434,,1,1,2,1,1,2,1,1,1,0,15,0.00082,0.000228
2902601895,2902601895,,2,4,6,2,5,7,7,0.329796,0.374743,0.000032,13,0.001471,0.045542
701388779114930176,701388779114930176,,1,1,2,3,1,4,1,1,1,0,19,0.00082,0.000237
324987074,324987074,,2,4,6,2,4,6,5,0.433036,0.471134,0.000002,5,0.000842,0.022663
3298655780,3298655780,,3,0,3,4,0,4,0,0,0,0,19,0.000853,0
784489264100827136,784489264100827136,,1,2,3,1,2,3,2,0.666667,0.75,0,15,0.00082,0.000685
2438695631,2438695631,,1,0,1,1,0,1,0,0,0,0,19,0.00082,0
449736439,449736439,,2,1,3,2,1,3,1,1,1,0,15,0.000842,0.001469
974090952603308032,974090952603308032,,0,2,2,0,2,2,2,0.583333,0.642857,0,28,0,0.000022
508816367,508816367,,3,5,8,4,6,10,1,1,1,0.000001,28,0.000006,0
1261050341447077888,1261050341447077888,,0,1,1,0,1,1,1,1,1,0,20,0,0
1365274787862491136,1365274787862491136,,2,0,2,2,0,2,0,0,0,0,20,0,0
385078207,385078207,,0,1,1,0,1,1,1,1,1,0,20,0,0
583646517,583646517,,0,1,1,0,1,1,2,0.666667,0.75,0,21,0,0.000611
997222792805351424,997222792805351424,,0,1,1,0,1,1,1,1,1,0,28,0,0.000022
1405888434917593088,1405888434917593088,,0,7,7,0,7,7,9,0.219117,0.239996,0,15,0,0.019675
1243490123855138816,1243490123855138816,,11,2,13,12,2,14,1,1,1,0.000037,15,0.006895,0
1245445880540467200,1245445880540467200,,0,8,8,0,9,9,7,0.313808,0.346508,0,14,0,0.046105
144443904,144443904,,1,0,1,1,0,1,0,0,0,0,14,0.001347,0
4863959205,4863959205,,2,0,2,2,0,2,0,0,0,0,14,0.001953,0
1342223197131993088,1342223197131993088,,0,9,9,0,9,9,10,0.23684,0.267402,0,37,0,0.02794
72237914,72237914,,3,0,3,3,0,3,0,0,0,0,37,0.001443,0
717970219596165120,717970219596165120,,0,1,1,0,1,1,9,0.205166,0.21661,0,15,0,0.000162
1227301302251794432,1227301302251794432,,0,1,1,0,1,1,1,1,1,0,28,0,0
1374652910,1374652910,,0,1,1,0,1,1,1,1,1,0,28,0,0.000022
853916380369956864,853916380369956864,,0,1,1,0,1,1,1,1,1,0,28,0,0
1054341027245551616,1054341027245551616,,3,0,3,3,0,3,0,0,0,0,28,0.000002,0
807580974,807580974,,0,1,1,0,1,1,9,0.247311,0.279001,0,15,0,0.001028
46631886,46631886,,0,1,1,0,1,1,1,1,1,0,28,0,0.000022
731573199557808128,731573199557808128,,0,1,1,0,1,1,2,0.666667,0.75,0,21,0,0.000611
1340788504272523264,1340788504272523264,,1,18,19,2,28,30,9,0.25636,0.283137,0.000035,250,0.000054,0.000326
1382967937,1382967937,,0,1,1,0,1,1,1,1,1,0,28,0,0.000022
1356373843678535680,1356373843678535680,,0,1,1,0,1,1,1,1,1,0,28,0,0.000022
292651184,292651184,,0,1,1,0,1,1,1,1,1,0,28,0,0.000022
623027480,623027480,,0,1,1,0,1,1,1,1,1,0,28,0,0.000022
1417088927299670016,1417088927299670016,,50,0,50,50,0,50,0,0,0,0,18,0.019966,0
2300291910,2300291910,,11,0,11,11,0,11,0,0,0,0,13,0.003489,0
422576910,422576910,,1,0,1,2,0,2,0,0,0,0,15,0.000033,0
1127922785723068416,1127922785723068416,,2,0,2,3,0,3,0,0,0,0,15,0.000033,0
98604466,98604466,,0,1,1,0,1,1,1,1,1,0,28,0,0.000022
578936615,578936615,,0,1,1,0,1,1,2,0.666667,0.75,0,21,0,0.000611
1174725921175158784,1174725921175158784,,0,1,1,0,1,1,1,1,1,0,28,0,0.000022
2589338447,2589338447,,0,1,1,0,1,1,1,1,1,0,28,0,0.000022
1036307375744016384,1036307375744016384,,3,24,27,3,24,27,7,0.29862,0.322765,0.000008,9,0.002396,0.000738
1912357064,1912357064,,19,13,32,19,13,32,3,0.772727,0.872549,0.000104,9,0.00925,0.000019
1410898242397691904,1410898242397691904,,0,4,4,0,4,4,3,0.578947,0.666667,0,15,0,0.019262
702758072629010432,702758072629010432,,0,3,3,0,3,3,1,1,1,0,28,0,0.000024
1044352496624431104,1044352496624431104,,1,0,1,1,0,1,0,0,0,0,28,0.000001,0
4882542093,4882542093,,4,1,5,7,2,9,1,1,1,0,9,0.001846,0
13514762,13514762,,4,2,6,8,4,12,2,0.75,0.833333,0.000014,25,0.000687,0
1405566685726248960,1405566685726248960,,1,0,1,2,0,2,0,0,0,0,250,0.00001,0
47626792,47626792,,3,3,6,6,8,14,1,1,1,0.000005,13,0.000135,0.000002
1144934970244378624,1144934970244378624,,1,0,1,2,0,2,0,0,0,0,250,0.00001,0
524217644,524217644,,1,0,1,2,0,2,0,0,0,0,250,0.00001,0
221681749,221681749,,1,0,1,2,0,2,0,0,0,0,250,0.00001,0
883724976158887936,883724976158887936,,1,5,6,1,6,7,9,0.224623,0.243326,0.000007,15,0.00001,0.001421
1248307267,1248307267,,3,12,15,3,12,15,6,0.424099,0.462901,0.000028,9,0.000087,0.057156
1063806444380798976,1063806444380798976,,2,1,3,2,1,3,1,1,1,0.000001,14,0.000736,0.000023
836271002,836271002,,2,9,11,2,11,13,7,0.326378,0.37262,0.00008,250,0.000085,0.05094
734074574275514368,734074574275514368,,2,0,2,2,0,2,0,0,0,0,250,0.000085,0
1238800491632607232,1238800491632607232,,2,3,5,2,3,5,2,0.8,0.875,0,5,0.00002,0.020979
45348536,45348536,,0,7,7,0,9,9,5,0.477218,0.492546,0,28,0,0.000103
53154047,53154047,,1,1,2,1,1,2,1,1,1,0,28,0.000003,0
2338169095,2338169095,,4,1,5,5,1,6,1,1,1,0,28,0.000004,0
760461108184551424,760461108184551424,,9,0,9,9,0,9,0,0,0,0,28,0.00001,0
2301664084,2301664084,,0,1,1,0,1,1,1,1,1,0,28,0,0
420221563,420221563,,2,0,2,2,0,2,0,0,0,0,28,0.000001,0
1258380213232304128,1258380213232304128,,0,5,5,0,5,5,7,0.332674,0.368334,0,21,0,0.011765
910668583784652800,910668583784652800,,5,0,5,7,0,7,0,0,0,0,18,0.001504,0
957969139452309504,957969139452309504,,3,0,3,3,0,3,0,0,0,0,5,0.00066,0
1448198883008466944,1448198883008466944,,7,0,7,7,0,7,0,0,0,0,9,0.006275,0
50616524,50616524,,5,1,6,6,1,7,2,0.666667,0.75,0,5,0.002226,0.020692
418508915,418508915,,3,0,3,4,0,4,0,0,0,0,18,0.000616,0
1321239578527805440,1321239578527805440,,2,0,2,2,0,2,0,0,0,0,18,0.000616,0
45120224,45120224,,2,0,2,2,0,2,0,0,0,0,13,0.001768,0
1427359828482068480,1427359828482068480,,1,8,9,2,10,12,8,0.285864,0.340871,0.000021,13,0.00002,0.028428
2406506894,2406506894,,2,2,4,3,2,5,3,0.5,0.560606,0.000006,9,0.000096,0.001067
1258385175433617408,1258385175433617408,,7,3,10,7,4,11,2,0.8,0.875,0.00001,9,0.002279,0.021295
1322543941,1322543941,,2,9,11,2,9,11,9,0.23348,0.268196,0.000057,15,0.000023,0.030679
585631312,585631312,,2,0,2,2,0,2,0,0,0,0,9,0.00023,0
2153639454,2153639454,,13,1,14,14,1,15,1,1,1,0.000003,15,0.00486,0
914523610894733312,914523610894733312,,0,1,1,0,1,1,1,1,1,0,28,0,0.000022
1302616789348691968,1302616789348691968,,14,5,19,14,6,20,7,0.289617,0.314683,0.000037,9,0.007675,0.000033
2442105406,2442105406,,11,0,11,11,0,11,0,0,0,0,18,0.001306,0
1389683859994906624,1389683859994906624,,1,1,2,1,1,2,2,0.666667,0.75,0,5,0,0.020692
548477556,548477556,,0,1,1,0,1,1,1,1,1,0,28,0,0.000022
771021205214224384,771021205214224384,,0,1,1,0,1,1,4,0.384615,0.483333,0,15,0,0.00007
1620000878,1620000878,,2,0,2,2,0,2,0,0,0,0,206,0.000128,0
3290570284,3290570284,,0,1,1,0,1,1,4,0.384615,0.483333,0,15,0,0.00007
4196122397,4196122397,,15,0,15,15,0,15,0,0,0,0,5,0.008325,0
391237371,391237371,,0,1,1,0,1,1,1,1,1,0,28,0,0.000022
1439264886631059456,1439264886631059456,,0,11,11,0,12,12,9,0.244584,0.285667,0,15,0,0.032821
864927221546405888,864927221546405888,,2,3,5,2,4,6,7,0.289498,0.310207,0.000001,21,0.00114,0.000025
891668225909510144,891668225909510144,,1,1,2,1,2,3,1,1,1,0,13,0.00001,0.000584
1235244517307166720,1235244517307166720,,3,7,10,3,7,10,2,0.888889,0.9375,0.000011,14,0.000798,0
200853690,200853690,,0,1,1,0,1,1,1,1,1,0,28,0,0.000022
1250020285,1250020285,,2,0,2,4,0,4,0,0,0,0,21,0.0023,0
1220673282191523840,1220673282191523840,,1,0,1,2,0,2,0,0,0,0,9,0.001186,0
1428661827395899392,1428661827395899392,,3,7,10,3,7,10,7,0.343257,0.382309,0.000044,9,0.001243,0.037095
1370300701,1370300701,,2,4,6,2,4,6,6,0.361913,0.405774,0.000005,15,0.002066,0.009935
814948333957632000,814948333957632000,,4,2,6,4,2,6,7,0.328891,0.372657,0.000046,14,0.001924,0.006925
785129133009494016,785129133009494016,,1,9,10,1,9,10,9,0.267468,0.310927,0.000009,9,0.001186,0.015229
1357265179470348288,1357265179470348288,,1,0,1,1,0,1,0,0,0,0,9,0.001186,0
704078981591646208,704078981591646208,,0,5,5,0,6,6,9,0.250716,0.285986,0,15,0,0.003058
1202342272714649600,1202342272714649600,,5,0,5,5,0,5,0,0,0,0,13,0.00009,0
1269285138,1269285138,,0,1,1,0,1,1,2,0.666667,0.75,0,21,0,0.000611
570631028,570631028,,1,0,1,1,0,1,0,0,0,0,9,0.000142,0
3047940471,3047940471,,1,1,2,1,1,2,2,0.666667,0.75,0,9,0.000142,0.020692
929733634323615744,929733634323615744,,1,2,3,1,2,3,2,0.666667,0.75,0,21,0.000142,0.017994
1232966449637023744,1232966449637023744,,1,0,1,2,0,2,0,0,0,0,9,0.000142,0
1387303997619507200,1387303997619507200,,1,2,3,1,2,3,3,0.52,0.564103,0.000001,5,0.000142,0.000348
234543153,234543153,,1,0,1,1,0,1,0,0,0,0,9,0.000142,0
1054491910088343552,1054491910088343552,,1,0,1,1,0,1,0,0,0,0,5,0.000635,0
1022555336463532032,1022555336463532032,,0,4,4,0,4,4,5,0.453704,0.476871,0,28,0,0.00007
2326660325,2326660325,,12,0,12,12,0,12,0,0,0,0,28,0.000019,0
1438593855562125312,1438593855562125312,,1,0,1,1,0,1,0,0,0,0,110,0.000961,0
1233474285655744512,1233474285655744512,,0,1,1,0,1,1,1,1,1,0,28,0,0.000022
53492718,53492718,,0,1,1,0,1,1,1,1,1,0,28,0,0.000022
715183461984833536,715183461984833536,,0,3,3,0,3,3,2,0.714286,0.8,0,5,0,0.018781
2810546613,2810546613,,16,0,16,16,0,16,0,0,0,0,5,0.008402,0
971351907313864704,971351907313864704,,0,2,2,0,2,2,5,0.450575,0.473129,0,28,0,0.000068
826773798624038912,826773798624038912,,0,1,1,0,1,1,1,1,1,0,28,0,0.000022
3023245491,3023245491,,0,6,6,0,6,6,9,0.268645,0.317641,0,206,0,0.027791
1088188856543920128,1088188856543920128,,0,1,1,0,1,1,1,1,1,0,28,0,0.000022
832999521739214848,832999521739214848,,0,8,8,0,8,8,9,0.26864,0.31857,0,15,0,0.014599
1095682906587086848,1095682906587086848,,0,1,1,0,1,1,1,1,1,0,28,0,0.000022
458703713,458703713,,0,13,13,0,13,13,8,0.259118,0.284663,0,15,0,0.000077
210153081,210153081,,1,3,4,1,3,4,6,0.377588,0.41913,0.000009,15,0.000002,0.01053
883083534,883083534,,1,0,1,1,0,1,0,0,0,0,15,0.000002,0
1418185538570424320,1418185538570424320,,1,0,1,1,0,1,0,0,0,0,15,0.000002,0
856054100236132352,856054100236132352,,1,2,3,1,2,3,2,0.666667,0.75,0,15,0.000002,0.038617
700841898,700841898,,2,3,5,2,3,5,8,0.240007,0.255492,0.000037,250,0.000078,0.021233
370617029,370617029,,2,7,9,2,8,10,3,0.636364,0.738095,0.000009,15,0.00001,0.025495
2665337999,2665337999,,3,5,8,3,5,8,6,0.397849,0.438851,0.000045,15,0.000662,0.028599
1430968548080369664,1430968548080369664,,2,2,4,2,2,4,3,0.478261,0.545455,0.000007,5,0.000078,0.017972
783015635181789184,783015635181789184,,3,2,5,4,2,6,7,0.272672,0.305848,0.00003,13,0.001208,0.002176
1088465527721345024,1088465527721345024,,2,1,3,2,1,3,1,1,1,0,15,0.000221,0.000155
1418899358649618432,1418899358649618432,,2,0,2,2,0,2,0,0,0,0,15,0.000078,0
1233041058264690688,1233041058264690688,,2,3,5,2,3,5,5,0.434783,0.473095,0.000023,15,0.000212,0.001989
2236516034,2236516034,,2,2,4,2,2,4,2,0.75,0.833333,0,15,0.000078,0.019438
172028905,172028905,,0,3,3,0,4,4,5,0.452434,0.475061,0,28,0,0.000068
1390980497636040704,1390980497636040704,,1,0,1,2,0,2,0,0,0,0,15,0.0002,0
546610139,546610139,,0,5,5,0,5,5,8,0.319779,0.363384,0,21,0,0.025494
830816872652218368,830816872652218368,,3,0,3,3,0,3,0,0,0,0,21,0.000746,0
1406528739798884352,1406528739798884352,,1,0,1,1,0,1,0,0,0,0,37,0.000141,0
2839490926,2839490926,,1,0,1,1,0,1,0,0,0,0,37,0.000141,0
2438584635,2438584635,,1,0,1,1,0,1,0,0,0,0,37,0.000141,0
241289430,241289430,,1,2,3,1,2,3,7,0.279386,0.315403,0.000002,37,0.000141,0.00217
1377439021,1377439021,,2,4,6,4,4,8,8,0.286394,0.324976,0.00003,37,0.000141,0.005
1183820211914457088,1183820211914457088,,1,0,1,1,0,1,0,0,0,0,37,0.000141,0
1388269877291634688,1388269877291634688,,2,3,5,2,3,5,7,0.330445,0.365219,0.000007,37,0.000163,0.011113
1040890639200780288,1040890639200780288,,1,7,8,1,8,9,7,0.288773,0.316564,0.000005,18,0.000141,0.009
1443503718092218368,1443503718092218368,,1,0,1,1,0,1,0,0,0,0,37,0.000141,0
448238925,448238925,,1,2,3,1,2,3,4,0.430769,0.479167,0.000001,37,0.000141,0.003582
1159915009,1159915009,,1,1,2,1,1,2,1,1,1,0,37,0.000141,0.003445
1275154423,1275154423,,3,5,8,3,7,10,6,0.40355,0.44433,0.00032,15,0.00036,0.014095
2383579672,2383579672,,1,0,1,1,0,1,0,0,0,0,37,0.000141,0
908445731891146752,908445731891146752,,1,1,2,1,1,2,1,1,1,0,37,0.000141,0.003445
602266773,602266773,,1,1,2,1,1,2,2,0.666667,0.75,0,37,0.000141,0.017924
1248588727997419520,1248588727997419520,,2,1,3,2,1,3,3,0.5,0.537037,0,14,0.000143,0.000348
1296006171862667264,1296006171862667264,,2,1,3,2,1,3,1,1,1,0,37,0.000153,0.003445
1146519594120679424,1146519594120679424,,0,1,1,0,1,1,2,0.666667,0.75,0,21,0,0.000611
4852347221,4852347221,,0,1,1,0,1,1,2,0.666667,0.75,0,21,0,0.000611
335247158,335247158,,1,2,3,1,3,4,5,0.430303,0.464085,0.000002,18,0.00018,0.001591
185696082,185696082,,1,0,1,1,0,1,0,0,0,0,18,0.00018,0
1382077226867429376,1382077226867429376,,1,0,1,1,0,1,0,0,0,0,18,0.00018,0
2497631817,2497631817,,2,3,5,2,3,5,7,0.249466,0.266611,0.000004,18,0.000993,0.000022
2943734350,2943734350,,2,0,2,3,0,3,0,0,0,0,18,0.000191,0
1444729651998375936,1444729651998375936,,1,1,2,1,1,2,2,0.666667,0.75,0,18,0.00018,0.020692
2195994661,2195994661,,2,0,2,3,0,3,0,0,0,0,206,0.00018,0
1278288701202857984,1278288701202857984,,2,0,2,2,0,2,0,0,0,0,18,0.00018,0
1049332184836964352,1049332184836964352,,4,1,5,4,1,5,1,1,1,0,18,0.000508,0
1206700701130334208,1206700701130334208,,1,1,2,1,2,3,1,1,1,0,18,0.00018,0
1422923897255735296,1422923897255735296,,1,1,2,1,1,2,3,0.5,0.611111,0,13,0.00018,0.000018
980305129,980305129,,2,1,3,2,1,3,1,1,1,0.000001,18,0.001333,0
1442798877330051072,1442798877330051072,,1,4,5,1,5,6,3,0.55,0.651515,0.000001,13,0.00018,0.000024
1405120559755759616,1405120559755759616,,3,1,4,3,1,4,2,0.666667,0.75,0,21,0.000321,0.020692
1195912231,1195912231,,2,2,4,2,3,5,8,0.303578,0.343438,0.000007,18,0.000256,0.004795
395179767,395179767,,2,5,7,2,5,7,2,0.777778,0.857143,0.000008,18,0.000256,0.000004
892349380665245696,892349380665245696,,0,1,1,0,1,1,1,1,1,0,28,0,0.000022
432637066,432637066,,0,5,5,0,5,5,5,0.444444,0.490046,0,21,0,0.004019
1423579622713794560,1423579622713794560,,1,0,1,1,0,1,0,0,0,0,21,0.000117,0
398032197,398032197,,0,6,6,0,6,6,10,0.223506,0.268606,0,110,0,0.006353
882965185237065728,882965185237065728,,4,1,5,5,2,7,1,1,1,0.000016,110,0.000354,0.000001
285650914,285650914,,0,2,2,0,2,2,2,0.75,0.833333,0,28,0,0.000022
1106146124606464000,1106146124606464000,,0,3,3,0,3,3,2,0.714286,0.8,0,28,0,0.000047
414373079,414373079,,7,1,8,8,2,10,1,1,1,0,28,0.000204,0
55238295,55238295,,51,1,52,51,1,52,1,1,1,0.000011,28,0.000679,0.000002
936947542746632192,936947542746632192,,0,1,1,0,1,1,1,1,1,0,28,0,0.000022
1138881045225451520,1138881045225451520,,3,1,4,3,1,4,2,0.666667,0.75,0,9,0.00058,0.020692
3252394091,3252394091,,3,10,13,3,10,13,8,0.268188,0.309073,0.000049,9,0.001811,0.032801
1268285799675637760,1268285799675637760,,0,1,1,0,1,1,2,0.666667,0.75,0,21,0,0.000611
1384867220661149696,1384867220661149696,,0,8,8,0,8,8,9,0.278793,0.327957,0,15,0,0.013298
1224809573913124864,1224809573913124864,,3,4,7,3,4,7,6,0.396694,0.437616,0.000006,15,0.001602,0.004276
3956390597,3956390597,,3,19,22,3,21,24,7,0.374196,0.410048,0.000042,14,0.001213,0.033492
245328223,245328223,,0,1,1,0,1,1,1,1,1,0,28,0,0.000022
3327831430,3327831430,,0,4,4,0,4,4,9,0.252394,0.286359,0,21,0,0.027141
1360978420084137984,1360978420084137984,,0,2,2,0,2,2,10,0.182934,0.193727,0,37,0,0.000612
2570596687,2570596687,,1,3,4,1,5,6,9,0.223208,0.241445,0.000014,37,0.000018,0.000004
1880399689,1880399689,,0,1,1,0,1,1,1,1,1,0,28,0,0.000022
4919837110,4919837110,,0,5,5,0,6,6,5,0.450526,0.474805,0,28,0,0.00007
2331847077,2331847077,,34,0,34,34,0,34,0,0,0,0,28,0.000049,0
3060144058,3060144058,,0,1,1,0,1,1,2,0.666667,0.75,0,21,0,0.000611
1008793418854813696,1008793418854813696,,0,1,1,0,1,1,1,1,1,0,28,0,0.000022
483025375,483025375,,10,1,11,10,1,11,1,1,1,0.000006,15,0.002517,0
186221116,186221116,,0,4,4,0,4,4,8,0.268297,0.294176,0,21,0,0.003255
430873229,430873229,,1,0,1,1,0,1,0,0,0,0,21,0.000095,0
392987772,392987772,,0,2,2,0,2,2,5,0.450575,0.473129,0,28,0,0.000068
2385068164,2385068164,,0,3,3,0,3,3,6,0.392663,0.43391,0,15,0,0.004878
1094614208107499520,1094614208107499520,,0,5,5,0,5,5,9,0.252372,0.286552,0,14,0,0.002084
15317484,15317484,,2,1,3,2,1,3,6,0.390411,0.429474,0.000004,14,0.001039,0.00415
730034081698877440,730034081698877440,,4,2,6,5,2,7,8,0.249111,0.268358,0.000016,14,0.001082,0.00006
2512399892,2512399892,,0,5,5,0,5,5,9,0.232981,0.25686,0,9,0,0.002367
755041728,755041728,,0,1,1,0,1,1,1,1,1,0,28,0,0.000022
171407778,171407778,,0,1,1,0,1,1,1,1,1,0,28,0,0.000022
402842940,402842940,,0,1,1,0,1,1,2,0.666667,0.75,0,21,0,0.000611
1231582922068676608,1231582922068676608,,0,3,3,0,3,3,7,0.274293,0.308824,0,21,0,0.002857
711462693044166656,711462693044166656,,0,1,1,0,1,1,1,1,1,0,28,0,0.000022
508688015,508688015,,0,4,4,0,4,4,6,0.393981,0.436574,0,9,0,0.025761
3094278383,3094278383,,0,8,8,0,8,8,11,0.20619,0.2548,0,15,0,0.006327
1241332888018321408,1241332888018321408,,1,0,1,2,0,2,0,0,0,0,21,0,0
1248044209,1248044209,,0,3,3,0,3,3,1,1,1,0,28,0,0.000022
381369966,381369966,,2,0,2,2,0,2,0,0,0,0,28,0.000002,0
522131924,522131924,,0,1,1,0,1,1,1,1,1,0,28,0,0.000022
988855532,988855532,,0,1,1,0,1,1,1,1,1,0,28,0,0.000022
3356630741,3356630741,,0,5,5,0,5,5,9,0.257352,0.295846,0,14,0,0.008671
210887564,210887564,,0,1,1,0,1,1,1,1,1,0,28,0,0.000022
733030567848071168,733030567848071168,,0,1,1,0,1,1,1,1,1,0,28,0,0.000022
971323446507589632,971323446507589632,,0,4,4,0,4,4,3,0.529412,0.666667,0,25,0,0.000032
234339579,234339579,,3,2,5,3,3,6,2,0.625,0.7,0,25,0.000001,0.000036
616886078,616886078,,58,0,58,58,0,58,0,0,0,0,33,0.001018,0
483665419,483665419,,0,4,4,0,4,4,7,0.285994,0.308912,0,15,0,0.024316
405027799,405027799,,0,1,1,0,1,1,1,1,1,0,28,0,0.000022
1420742058457763840,1420742058457763840,,0,2,2,0,2,2,2,0.75,0.833333,0,28,0,0.020714
903258170214187008,903258170214187008,,0,2,2,0,2,2,7,0.247113,0.261109,0,28,0,0.000022
1427420742,1427420742,,0,4,4,0,4,4,9,0.219922,0.236666,0,14,0,0.019138
1122184239523553280,1122184239523553280,,0,1,1,0,1,1,1,1,1,0,28,0,0.000022
1042691054,1042691054,,0,6,6,0,7,7,9,0.220275,0.237936,0,13,0,0.040494
1148226661,1148226661,,0,3,3,0,3,3,9,0.227138,0.251267,0,206,0,0.01828
1402866679332356096,1402866679332356096,,0,4,4,0,4,4,7,0.32982,0.374449,0,14,0,0.024965
435853483,435853483,,0,1,1,0,1,1,1,1,1,0,28,0,0.000022
763323474551181312,763323474551181312,,0,9,9,0,10,10,7,0.306033,0.340572,0,14,0,0.033578
1443706704,1443706704,,4,0,4,4,0,4,0,0,0,0,18,0.001882,0
1252956319608438784,1252956319608438784,,1,0,1,1,0,1,0,0,0,0,18,0.000541,0
1438838832774930432,1438838832774930432,,1,0,1,1,0,1,0,0,0,0,18,0.000541,0
1249405631808692224,1249405631808692224,,1,0,1,1,0,1,0,0,0,0,18,0.000541,0
941041278,941041278,,3,9,12,5,9,14,8,0.234671,0.265906,0.000056,18,0.00141,0.041009
1226925410556006400,1226925410556006400,,2,2,4,2,3,5,2,0.75,0.833333,0,18,0.000541,0.01794
503338054,503338054,,1,1,2,1,1,2,1,1,1,0,18,0.000541,0.000866
985259745975197696,985259745975197696,,2,6,8,2,6,8,2,0.875,0.928571,0.000011,18,0.000751,0.026737
326183612,326183612,,1,0,1,2,0,2,0,0,0,0,18,0.000541,0
1283784692,1283784692,,1,1,2,1,1,2,1,1,1,0,18,0.000541,0.003445
1005911696316293120,1005911696316293120,,2,2,4,3,3,6,2,0.666667,0.75,0,18,0.001191,0.038617
1166451475821846528,1166451475821846528,,3,0,3,4,0,4,0,0,0,0,18,0.000548,0
871143564947988480,871143564947988480,,3,0,3,3,0,3,0,0,0,0,18,0.00056,0
801569962921955328,801569962921955328,,1,0,1,1,0,1,0,0,0,0,18,0.000541,0
2334456615,2334456615,,2,0,2,2,0,2,0,0,0,0,18,0.000751,0
389711722,389711722,,4,3,7,4,3,7,7,0.273399,0.307963,0.000017,110,0.001808,0.022982
4859931532,4859931532,,2,3,5,2,3,5,3,0.508197,0.537634,0.000016,18,0.000549,0.019018
265679140,265679140,,2,2,4,2,2,4,9,0.2,0.227012,0.000005,18,0.000541,0.001972
2951425072,2951425072,,2,7,9,2,8,10,6,0.405728,0.448578,0.000008,14,0.000617,0.014497
1169174599885611008,1169174599885611008,,1,1,2,1,1,2,2,0.666667,0.75,0,18,0.000541,0.020692
980629135,980629135,,1,5,6,1,5,6,9,0.197608,0.216175,0.000025,18,0.000541,0.021142
761170444904964096,761170444904964096,,1,0,1,1,0,1,0,0,0,0,18,0.000541,0
965309946165387264,965309946165387264,,1,1,2,1,1,2,1,1,1,0,18,0.000541,0.001513
834419884205469696,834419884205469696,,2,3,5,2,3,5,11,0.174402,0.188326,0.000035,15,0.000617,0.000512
1458395058,1458395058,,3,5,8,3,7,10,7,0.281132,0.303292,0.000006,110,0.001343,0.004898
1088122584007393280,1088122584007393280,,0,1,1,0,1,1,8,0.246116,0.260917,0,14,0,0.000541
248853637,248853637,,0,1,1,0,1,1,1,1,1,0,28,0,0.000022
1174780873075544064,1174780873075544064,,0,10,10,0,11,11,6,0.400517,0.448172,0,13,0,0.023029
1371456196679450624,1371456196679450624,,5,1,6,6,1,7,2,0.666667,0.75,0,13,0.00288,0.020692
893527335789580288,893527335789580288,,4,2,6,4,2,6,1,1,1,0,13,0.002567,0.000365
358711428,358711428,,2,6,8,2,6,8,8,0.225513,0.247194,0.000005,13,0.00068,0.000002
2989721327,2989721327,,4,1,5,4,1,5,1,1,1,0,13,0.000674,0
1401075900477841408,1401075900477841408,,1,0,1,1,0,1,0,0,0,0,13,0.000673,0
1699728120,1699728120,,0,3,3,0,3,3,8,0.24274,0.255417,0,14,0,0.000769
329937650,329937650,,0,2,2,0,2,2,1,1,1,0,28,0,0.00003
19852533,19852533,,0,0,0,0,0,0,0,0,0,0,22,0,0
770206242824413184,770206242824413184,,0,5,5,0,5,5,1,1,1,0,28,0,0.000022
441711583,441711583,,1,0,1,1,0,1,0,0,0,0,28,0.000001,0
800122116,800122116,,1,0,1,1,0,1,0,0,0,0,28,0.000001,0
400801252,400801252,,1,0,1,1,0,1,0,0,0,0,28,0.000001,0
504694768,504694768,,0,2,2,0,2,2,10,0.155708,0.166125,0,14,0,0.01804
1240214959776239616,1240214959776239616,,0,3,3,0,3,3,2,0.551724,0.59375,0,28,0,0.000025
977383349235961856,977383349235961856,,15,13,28,15,13,28,1,1,1,0.000071,57,0.000129,0
1190915802595282944,1190915802595282944,,0,0,0,0,0,0,0,0,0,0,23,0,0
1864422026,1864422026,,0,1,1,0,1,1,10,0.155218,0.162578,0,14,0,0.000115
2954454747,2954454747,,0,2,2,0,2,2,9,0.21976,0.235783,0,14,0,0.000601
452294805,452294805,,0,2,2,0,2,2,2,0.75,0.833333,0,28,0,0.000042
1100504063957962752,1100504063957962752,,1,1,2,1,1,2,1,1,1,0,14,0.000076,0.001513
1440646101187510272,1440646101187510272,,1,0,1,1,0,1,0,0,0,0,15,0.000076,0
1050393979777441792,1050393979777441792,,1,3,4,1,3,4,6,0.427842,0.46,0.000005,14,0.000076,0.006742
1430032390366375936,1430032390366375936,,1,1,2,1,1,2,1,1,1,0,14,0.000076,0.001513
1424436742023692288,1424436742023692288,,1,0,1,1,0,1,0,0,0,0,15,0.000076,0
1274015443297153024,1274015443297153024,,1,0,1,1,0,1,0,0,0,0,15,0.000076,0
834079758447177728,834079758447177728,,1,0,1,1,0,1,0,0,0,0,15,0.000076,0
1241793434337378304,1241793434337378304,,1,0,1,1,0,1,0,0,0,0,15,0.000076,0
845313296,845313296,,1,1,2,1,1,2,8,0.246116,0.260917,0.000003,14,0.000076,0.000541
1437067632,1437067632,,1,3,4,1,3,4,8,0.253155,0.270886,0.000013,15,0.000076,0.020884
1432483917756616704,1432483917756616704,,1,1,2,1,2,3,3,0.5,0.611111,0.000001,15,0.000076,0
1250167243549356032,1250167243549356032,,1,1,2,1,1,2,1,1,1,0,37,0.000076,0.003445
1216467327962750976,1216467327962750976,,1,1,2,1,1,2,7,0.272226,0.304285,0.000003,14,0.000076,0.002135
1258361335240425472,1258361335240425472,,1,3,4,1,3,4,8,0.303765,0.344245,0.000003,25,0.000076,0.026103
3176594760,3176594760,,1,0,1,1,0,1,0,0,0,0,15,0.000076,0
1011141461084172288,1011141461084172288,,1,5,6,1,5,6,8,0.271806,0.299228,0.000008,13,0.000076,0.021633
398934233,398934233,,1,1,2,1,1,2,8,0.303216,0.342457,0.000003,9,0.000076,0.00479
2877822448,2877822448,,1,1,2,1,1,2,8,0.303216,0.342457,0.000003,9,0.000076,0.00479
856146804823535616,856146804823535616,,1,0,1,1,0,1,0,0,0,0,15,0.000076,0
2847298505,2847298505,,1,1,2,1,1,2,6,0.390411,0.429474,0.000002,9,0.000076,0.00415
1345781531533602816,1345781531533602816,,1,5,6,1,5,6,8,0.270848,0.297739,0.000005,15,0.000076,0.025684
1375782297136422912,1375782297136422912,,1,0,1,1,0,1,0,0,0,0,15,0.000076,0
68159375,68159375,,1,1,2,1,1,2,2,0.666667,0.75,0,15,0.000076,0.017924
2271291772,2271291772,,1,2,3,1,4,5,6,0.391484,0.431813,0.000002,13,0.000076,0.022074
589178819,589178819,,1,3,4,1,3,4,6,0.392906,0.434259,0.000004,9,0.000076,0.024863
101477717,101477717,,1,0,1,1,0,1,0,0,0,0,15,0.000076,0
1160826529624023040,1160826529624023040,,1,3,4,2,3,5,7,0.249725,0.266903,0.000005,15,0.000076,0.000112
1345309453277679616,1345309453277679616,,1,1,2,1,1,2,1,1,1,0,15,0.000076,0.001469
130106591,130106591,,1,1,2,1,1,2,2,0.666667,0.75,0,15,0.000076,0.017924
1256632964324167680,1256632964324167680,,1,0,1,1,0,1,0,0,0,0,15,0.000076,0
134923768,134923768,,1,0,1,1,0,1,0,0,0,0,15,0.000076,0
917489642777214976,917489642777214976,,1,3,4,1,4,5,8,0.270594,0.296582,0.000005,13,0.000076,0.040763
1327003044748398592,1327003044748398592,,1,1,2,1,1,2,10,0.20915,0.234986,0.000012,110,0.000076,0.000353
387552699,387552699,,1,2,3,1,2,3,3,0.5,0.522222,0.000001,14,0.000076,0.018926
1162361772415836160,1162361772415836160,,2,1,3,2,1,3,2,0.666667,0.75,0,15,0.000079,0.017924
175557075,175557075,,1,1,2,1,1,2,1,1,1,0,15,0.000076,0.001469
437573164,437573164,,1,1,2,1,1,2,1,1,1,0,37,0.000076,0.003445
497382096,497382096,,1,2,3,1,2,3,8,0.303655,0.34355,0.000003,9,0.000076,0.022715
1471608194,1471608194,,1,0,1,1,0,1,0,0,0,0,15,0.000076,0
586736890,586736890,,1,3,4,1,3,4,7,0.303778,0.341994,0.000007,18,0.000076,0.007266
1308714015938482176,1308714015938482176,,1,0,1,1,0,1,0,0,0,0,15,0.000076,0
1420443511,1420443511,,1,3,4,1,4,5,9,0.209089,0.222884,0.000001,18,0.000076,0.001363
2243436705,2243436705,,1,1,2,1,1,2,7,0.283203,0.300698,0,9,0.000076,0.004809
1256281069533515776,1256281069533515776,,1,1,2,1,1,2,4,0.45,0.486111,0.000002,9,0.000076,0.00027
981804851595239424,981804851595239424,,1,3,4,1,3,4,7,0.273231,0.307851,0.000003,15,0.000076,0.021528
1384851982817677312,1384851982817677312,,1,0,1,1,0,1,0,0,0,0,15,0.000076,0
2578097062,2578097062,,1,0,1,1,0,1,0,0,0,0,15,0.000076,0
1295339722731065344,1295339722731065344,,1,1,2,1,1,2,2,0.666667,0.75,0,5,0.000076,0.020692
710579736519512064,710579736519512064,,1,5,6,1,5,6,8,0.256614,0.276819,0.000011,13,0.000076,0.000046
1381330823685750784,1381330823685750784,,1,0,1,1,0,1,0,0,0,0,15,0.000076,0
467361179,467361179,,1,1,2,1,1,2,6,0.390411,0.429474,0.000002,9,0.000076,0.00415
1086702385,1086702385,,1,4,5,1,5,6,2,0.7,0.785714,0,13,0.000076,0.040508
1259956684988067840,1259956684988067840,,1,0,1,1,0,1,0,0,0,0,15,0.000076,0
1414274831684677632,1414274831684677632,,1,1,2,1,1,2,2,0.666667,0.75,0,15,0.000076,0.017924
1445325148618375168,1445325148618375168,,1,0,1,1,0,1,0,0,0,0,15,0.000076,0
975317561742110720,975317561742110720,,1,0,1,1,0,1,0,0,0,0,15,0.000076,0
1054006207323750400,1054006207323750400,,1,0,1,1,0,1,0,0,0,0,15,0.000076,0
1217498407843004416,1217498407843004416,,1,0,1,1,0,1,0,0,0,0,15,0.000076,0
1085622362119254016,1085622362119254016,,1,2,3,1,2,3,6,0.391484,0.431813,0.000002,21,0.000076,0.005016
941702501585379328,941702501585379328,,1,0,1,1,0,1,0,0,0,0,15,0.000076,0
766643303081250816,766643303081250816,,1,2,3,1,2,3,8,0.270467,0.296004,0.000005,13,0.000076,0.022838
3351692872,3351692872,,1,0,1,1,0,1,0,0,0,0,15,0.000076,0
1106657127077240832,1106657127077240832,,1,0,1,1,0,1,0,0,0,0,15,0.000076,0
19592755,19592755,,1,1,2,1,1,2,8,0.303216,0.342457,0.000003,9,0.000076,0.00479
1390620869718855680,1390620869718855680,,1,0,1,1,0,1,0,0,0,0,15,0.000076,0
2831677321,2831677321,,1,2,3,1,2,3,1,1,1,0.000001,5,0.000076,0.000289
1032926207938109440,1032926207938109440,,1,0,1,1,0,1,0,0,0,0,15,0.000076,0
1439213209894936576,1439213209894936576,,1,12,13,1,12,13,11,0.232614,0.316192,0.000027,15,0.000076,0.052846
1446813584261013504,1446813584261013504,,1,2,3,1,2,3,5,0.436709,0.469082,0.000002,15,0.000076,0.019514
1040715474,1040715474,,1,0,1,1,0,1,0,0,0,0,15,0.000076,0
2728402871,2728402871,,1,0,1,1,0,1,0,0,0,0,15,0.000076,0
3152758571,3152758571,,1,2,3,1,2,3,6,0.388158,0.429266,0.000002,18,0.000076,0.00512
579662557,579662557,,1,0,1,1,0,1,0,0,0,0,15,0.000076,0
929249360,929249360,,1,2,3,1,2,3,8,0.270403,0.29586,0.000005,15,0.000076,0.003615
1236336724399329280,1236336724399329280,,1,5,6,1,5,6,6,0.384416,0.427252,0.000005,9,0.000076,0.013549
774960960696188928,774960960696188928,,1,1,2,1,1,2,1,1,1,0,21,0.000076,0.000866
1011310374535213056,1011310374535213056,,1,0,1,1,0,1,0,0,0,0,15,0.000076,0
1079458256949575680,1079458256949575680,,1,5,6,1,5,6,7,0.329929,0.375289,0.000007,13,0.000076,0.026385
1438796669986947072,1438796669986947072,,1,2,3,1,2,3,2,0.75,0.833333,0.000001,15,0.000076,0.02071
59793989,59793989,,1,0,1,1,0,1,0,0,0,0,15,0.000076,0
1439482405333708800,1439482405333708800,,1,3,4,1,3,4,3,0.5625,0.648148,0,15,0.000076,0.0218
11534652,11534652,,1,1,2,1,1,2,1,1,1,0,9,0.000076,0.000943
1231899811,1231899811,,1,4,5,1,4,5,10,0.243896,0.274016,0.000056,13,0.000076,0.002514
1219944530,1219944530,,1,4,5,1,4,5,8,0.282609,0.320682,0.000006,14,0.000076,0.004876
246993660,246993660,,1,0,1,1,0,1,0,0,0,0,15,0.000076,0
1000288907085385728,1000288907085385728,,1,0,1,1,0,1,0,0,0,0,15,0.000076,0
3381385042,3381385042,,1,0,1,1,0,1,0,0,0,0,15,0.000076,0
1330818619375280128,1330818619375280128,,1,0,1,1,0,1,0,0,0,0,15,0.000076,0
524224872,524224872,,1,0,1,1,0,1,0,0,0,0,15,0.000076,0
1371423626654793728,1371423626654793728,,1,0,1,1,0,1,0,0,0,0,15,0.000076,0
1152195212250419200,1152195212250419200,,1,0,1,1,0,1,0,0,0,0,15,0.000076,0
930579210,930579210,,1,1,2,1,2,3,8,0.239742,0.254313,0.000028,250,0.000076,0.000495
1396364070421471232,1396364070421471232,,1,0,1,1,0,1,0,0,0,0,15,0.000076,0
430743919,430743919,,1,1,2,1,1,2,1,1,1,0,15,0.000076,0.00039
338471154,338471154,,1,0,1,1,0,1,0,0,0,0,15,0.000076,0
1291622634,1291622634,,1,0,1,1,0,1,0,0,0,0,15,0.000076,0
999351943,999351943,,1,0,1,1,0,1,0,0,0,0,15,0.000076,0
875760634037776384,875760634037776384,,1,0,1,1,0,1,0,0,0,0,15,0.000076,0
1417840129838829568,1417840129838829568,,1,0,1,1,0,1,0,0,0,0,15,0.000076,0
1434258458656772096,1434258458656772096,,1,2,3,1,2,3,9,0.208933,0.222329,0,18,0.000076,0.004185
514356590,514356590,,1,0,1,1,0,1,0,0,0,0,15,0.000076,0
1213937974666153984,1213937974666153984,,1,1,2,1,1,2,4,0.421053,0.489583,0,15,0.000076,0.000431
3515611696,3515611696,,1,0,1,1,0,1,0,0,0,0,15,0.000076,0
1156548780780609536,1156548780780609536,,1,0,1,1,0,1,0,0,0,0,15,0.000076,0
1194237907910975488,1194237907910975488,,1,0,1,1,0,1,0,0,0,0,15,0.000076,0
1349364292894793728,1349364292894793728,,1,6,7,1,6,7,8,0.308084,0.349966,0.000014,5,0.000076,0.025575
1041831000,1041831000,,1,2,3,1,2,3,6,0.392022,0.432398,0.000002,21,0.000076,0.005098
1251810252732973056,1251810252732973056,,1,0,1,1,0,1,0,0,0,0,15,0.000076,0
1627031726,1627031726,,1,0,1,1,0,1,0,0,0,0,15,0.000076,0
100878763,100878763,,4,8,12,6,8,14,6,0.40256,0.441657,0.000082,13,0.000809,0.03355
911650004955226112,911650004955226112,,1,1,2,1,1,2,8,0.270277,0.295281,0.000005,13,0.000076,0.002146
3438529882,3438529882,,1,5,6,1,5,6,6,0.363361,0.407747,0.000007,57,0.000076,0.047803
1289570480740012032,1289570480740012032,,1,1,2,1,1,2,10,0.20915,0.234986,0.000012,110,0.000076,0.000353
1036560565,1036560565,,1,2,3,1,2,3,6,0.391363,0.431264,0.000002,9,0.000076,0.008958
987498296,987498296,,1,0,1,1,0,1,0,0,0,0,15,0.000076,0
1033842842286866432,1033842842286866432,,1,0,1,1,0,1,0,0,0,0,15,0.000076,0
479467597,479467597,,1,2,3,1,3,4,6,0.401198,0.439353,0.000003,15,0.000076,0.00574
100807491,100807491,,1,1,2,1,2,3,5,0.425926,0.455797,0.000002,15,0.000076,0.00159
2843958058,2843958058,,1,3,4,1,3,4,6,0.421208,0.455653,0.000004,15,0.000076,0.005156
1536096120,1536096120,,1,0,1,1,0,1,0,0,0,0,15,0.000076,0
137696273,137696273,,1,1,2,1,1,2,8,0.303216,0.342457,0.000003,9,0.000076,0.00479
831219408509030400,831219408509030400,,1,0,1,1,0,1,0,0,0,0,15,0.000076,0
1440445087498981376,1440445087498981376,,1,4,5,1,4,5,8,0.303986,0.345039,0.000004,13,0.000076,0.026688
1448982766251610112,1448982766251610112,,1,2,3,1,2,3,9,0.208959,0.222428,0,18,0.000076,0.021433
1905031909,1905031909,,1,0,1,1,0,1,0,0,0,0,15,0.000076,0
1361431440882159616,1361431440882159616,,1,0,1,1,0,1,0,0,0,0,15,0.000076,0
1343312524167569408,1343312524167569408,,1,0,1,1,0,1,0,0,0,0,15,0.000076,0
1537221842,1537221842,,1,0,1,1,0,1,0,0,0,0,15,0.000076,0
1309102515552694272,1309102515552694272,,1,8,9,1,9,10,6,0.364728,0.409445,0.000013,13,0.000076,0.019411
118141653,118141653,,1,1,2,1,1,2,1,1,1,0,37,0.000076,0.003445
516769801,516769801,,1,0,1,1,0,1,0,0,0,0,15,0.000076,0
414108131,414108131,,1,3,4,1,3,4,7,0.330448,0.365181,0.000004,15,0.000076,0.009669
433604815,433604815,,1,0,1,1,0,1,0,0,0,0,15,0.000076,0
713498795347218432,713498795347218432,,1,7,8,1,8,9,9,0.259919,0.31369,0.00002,13,0.000076,0.026095
1010807990,1010807990,,1,3,4,1,3,4,2,0.571429,0.625,0.000001,15,0.000076,0.038965
2284755698,2284755698,,1,4,5,1,4,5,9,0.213425,0.233363,0.000013,9,0.000076,0.021158
984646254,984646254,,1,2,3,1,2,3,2,0.75,0.833333,0,15,0.000076,0.020762
977960755919228928,977960755919228928,,1,2,3,1,3,4,7,0.272895,0.306349,0.000003,13,0.000076,0.020059
571304184,571304184,,1,2,3,3,2,5,6,0.391781,0.432051,0.000002,15,0.000076,0.024842
1033310908766924800,1033310908766924800,,1,0,1,1,0,1,0,0,0,0,15,0.000076,0
1200449290973396992,1200449290973396992,,1,1,2,1,1,2,6,0.390411,0.429474,0.000002,9,0.000076,0.00415
3179223957,3179223957,,2,12,14,2,13,15,7,0.340152,0.386343,0.000096,13,0.000077,0.057065
1098241328150908928,1098241328150908928,,1,5,6,1,5,6,6,0.404028,0.444819,0.000003,9,0.000076,0.049165
872009898145533952,872009898145533952,,1,1,2,1,1,2,2,0.666667,0.75,0,15,0.000076,0.017924
253714436,253714436,,1,1,2,1,1,2,1,1,1,0,18,0.000076,0.000583
1229998908732035072,1229998908732035072,,1,0,1,1,0,1,0,0,0,0,15,0.000076,0
1250177731,1250177731,,1,2,3,1,2,3,3,0.492308,0.515625,0.000004,14,0.000076,0.001003
1157917124,1157917124,,1,0,1,1,0,1,0,0,0,0,15,0.000076,0
1284852893695254528,1284852893695254528,,1,9,10,1,9,10,8,0.27597,0.311547,0.000038,18,0.000076,0.00783
555327098,555327098,,1,0,1,1,0,1,0,0,0,0,15,0.000076,0
576834361,576834361,,1,4,5,1,4,5,2,0.833333,0.9,0,9,0.000076,0.042674
880668519762886656,880668519762886656,,1,1,2,1,1,2,2,0.666667,0.75,0,15,0.000076,0.017924
1114817509910355968,1114817509910355968,,1,6,7,1,7,8,8,0.262517,0.292612,0.000008,13,0.000076,0.023584
1633653277,1633653277,,1,1,2,1,1,2,1,1,1,0,15,0.000076,0.000228
1180933974128025600,1180933974128025600,,1,0,1,1,0,1,0,0,0,0,15,0.000076,0
468772443,468772443,,1,2,3,1,2,3,6,0.388158,0.429266,0.000002,18,0.000076,0.00512
4187056599,4187056599,,1,0,1,1,0,1,0,0,0,0,15,0.000076,0
1133111378045284352,1133111378045284352,,1,1,2,1,1,2,4,0.37931,0.431818,0.000005,14,0.000076,0.000088
1291121696162947072,1291121696162947072,,1,0,1,1,0,1,0,0,0,0,15,0.000076,0
1001037676454309888,1001037676454309888,,1,1,2,1,1,2,4,0.421053,0.489583,0,15,0.000076,0.000431
394680267,394680267,,1,0,1,1,0,1,0,0,0,0,15,0.000076,0
479860435,479860435,,1,1,2,1,1,2,2,0.666667,0.75,0,15,0.000076,0.017924
973247240822280192,973247240822280192,,1,9,10,1,9,10,9,0.257279,0.303993,0.000026,15,0.000076,0.012574
2419772543,2419772543,,1,1,2,1,2,3,2,0.666667,0.75,0,13,0.000076,0.017924
495401644,495401644,,1,0,1,1,0,1,0,0,0,0,15,0.000076,0
549050267,549050267,,1,0,1,1,0,1,0,0,0,0,15,0.000076,0
827046914285830144,827046914285830144,,1,1,2,1,1,2,8,0.270277,0.295281,0.000005,13,0.000076,0.002146
421862447,421862447,,1,0,1,1,0,1,0,0,0,0,15,0.000076,0
67280822,67280822,,1,4,5,1,4,5,8,0.287291,0.334247,0.000008,15,0.000076,0.007279
2905237409,2905237409,,1,0,1,1,0,1,0,0,0,0,15,0.000076,0
2928096323,2928096323,,1,2,3,1,2,3,8,0.303436,0.343252,0.000003,37,0.000076,0.008235
1417374328849641472,1417374328849641472,,1,0,1,1,0,1,0,0,0,0,15,0.000076,0
404946715,404946715,,1,6,7,1,7,8,9,0.219051,0.236586,0.000024,15,0.000076,0.025049
1356156544229003264,1356156544229003264,,1,6,7,1,6,7,6,0.323893,0.356129,0.000005,15,0.000076,0.029631
70741097,70741097,,1,4,5,1,4,5,7,0.242684,0.264006,0.000004,110,0.000076,0.0042
909239401,909239401,,1,0,1,1,0,1,0,0,0,0,15,0.000076,0
965685004507537408,965685004507537408,,1,1,2,1,1,2,7,0.283203,0.300698,0,9,0.000076,0.004809
1108660999731728384,1108660999731728384,,1,1,2,1,1,2,8,0.303216,0.342457,0.000003,9,0.000076,0.00479
1080528002,1080528002,,1,0,1,1,0,1,0,0,0,0,15,0.000076,0
965165490653093888,965165490653093888,,1,0,1,1,0,1,0,0,0,0,15,0.000076,0
1169506849,1169506849,,1,3,4,1,4,5,10,0.231234,0.283186,0.00002,110,0.000076,0.005172
1428767360,1428767360,,1,1,2,1,1,2,7,0.283203,0.300698,0,9,0.000076,0.004809
875773544034168832,875773544034168832,,1,1,2,1,1,2,2,0.666667,0.75,0,5,0.000076,0.020692
945612625,945612625,,1,1,2,1,1,2,6,0.390411,0.429474,0.000002,9,0.000076,0.00415
3414902723,3414902723,,1,0,1,1,0,1,0,0,0,0,15,0.000076,0
2725216048,2725216048,,1,1,2,1,1,2,1,1,1,0,15,0.000076,0.00039
1166400933183545344,1166400933183545344,,1,0,1,1,0,1,0,0,0,0,15,0.000076,0
1125440833099112448,1125440833099112448,,1,7,8,1,9,10,6,0.417448,0.45427,0.000007,15,0.000076,0.01005
761121380,761121380,,2,0,2,3,0,3,0,0,0,0,13,0.000803,0
2753421268,2753421268,,1,0,1,1,0,1,0,0,0,0,15,0.000076,0
1381489063,1381489063,,1,3,4,1,4,5,7,0.330445,0.365219,0.000003,13,0.000076,0.027524
1196504849002770432,1196504849002770432,,1,6,7,1,7,8,8,0.249103,0.267931,0.000006,18,0.000076,0.00488
324293502,324293502,,1,1,2,1,1,2,8,0.270277,0.295281,0.000005,13,0.000076,0.002146
1430251762284367872,1430251762284367872,,1,0,1,1,0,1,0,0,0,0,15,0.000076,0
1436670330953773056,1436670330953773056,,1,5,6,1,5,6,7,0.3311,0.366967,0.000004,13,0.000076,0.030437
1421936444675923968,1421936444675923968,,1,2,3,1,2,3,2,0.666667,0.75,0,5,0.000076,0.038617
747184721935933440,747184721935933440,,1,0,1,1,0,1,0,0,0,0,15,0.000076,0
1313354509968642048,1313354509968642048,,1,7,8,1,7,8,6,0.364105,0.409119,0.000008,9,0.000076,0.014348
1418593443551531008,1418593443551531008,,1,2,3,1,2,3,6,0.379812,0.421021,0.000005,14,0.000076,0.006285
1318839618553466880,1318839618553466880,,1,4,5,1,5,6,7,0.331885,0.367066,0.000005,13,0.000076,0.027567
465526247,465526247,,1,1,2,1,1,2,1,1,1,0.000001,15,0.000076,0
1915578642,1915578642,,1,2,3,1,2,3,6,0.394771,0.433996,0.000006,25,0.000076,0.00452
1023883075594465280,1023883075594465280,,1,0,1,1,0,1,0,0,0,0,15,0.000076,0
1393166804,1393166804,,1,1,2,1,1,2,4,0.384615,0.483333,0.000001,15,0.000076,0.00007
361787988,361787988,,1,1,2,1,1,2,1,1,1,0,37,0.000076,0.003445
2767302910,2767302910,,1,0,1,1,0,1,0,0,0,0,15,0.000076,0
438534120,438534120,,1,5,6,1,5,6,7,0.340319,0.378406,0.000008,37,0.000076,0.035882
1352193336585711616,1352193336585711616,,1,0,1,1,0,1,0,0,0,0,15,0.000076,0
711830999227899904,711830999227899904,,2,7,9,2,7,9,8,0.306365,0.349458,0.000028,15,0.000076,0.027555
986292469682855936,986292469682855936,,1,1,2,1,1,2,1,1,1,0,21,0.000076,0.000866
928345597182177280,928345597182177280,,1,4,5,1,5,6,7,0.287266,0.310317,0.000001,15,0.000076,0.029147
1926516720,1926516720,,1,0,1,1,0,1,0,0,0,0,15,0.000076,0
1267386347481858048,1267386347481858048,,1,0,1,1,0,1,0,0,0,0,15,0.000076,0
4871884721,4871884721,,1,4,5,1,4,5,4,0.5,0.542929,0.000002,13,0.000076,0.023792
923182193551269888,923182193551269888,,2,3,5,2,4,6,3,0.526316,0.616667,0.000005,25,0.000689,0.01796
1163010755693830144,1163010755693830144,,1,0,1,1,0,1,0,0,0,0,15,0.000076,0
785860989745061888,785860989745061888,,1,1,2,1,1,2,2,0.666667,0.75,0,5,0.000076,0.020692
2828396831,2828396831,,1,1,2,1,1,2,4,0.421053,0.489583,0,15,0.000076,0.000431
1492549380,1492549380,,2,0,2,2,0,2,0,0,0,0,18,0.000087,0
3099826691,3099826691,,1,3,4,1,3,4,8,0.240043,0.255533,0.000028,15,0.000076,0.022657
1199676680140398592,1199676680140398592,,1,0,1,1,0,1,0,0,0,0,15,0.000076,0
717285518069874688,717285518069874688,,2,5,7,2,5,7,8,0.287742,0.324658,0.000103,18,0.000077,0.027002
1111179646538842112,1111179646538842112,,1,11,12,2,12,14,10,0.180484,0.200152,0.000009,15,0.000076,0.047458
581206231,581206231,,1,1,2,1,1,2,1,1,1,0,37,0.000076,0.003445
1296509725,1296509725,,2,2,4,2,2,4,2,0.666667,0.75,0.000003,110,0.000803,0.000641
472418074,472418074,,1,0,1,1,0,1,0,0,0,0,15,0.000076,0
2895077031,2895077031,,1,5,6,1,5,6,9,0.250349,0.294472,0.000017,15,0.000076,0.010211
1444189918276767744,1444189918276767744,,1,2,3,1,3,4,8,0.303655,0.34355,0.000003,13,0.000076,0.022715
421827186,421827186,,1,0,1,1,0,1,0,0,0,0,15,0.000076,0
236500073,236500073,,1,3,4,1,3,4,8,0.307132,0.348623,0.000005,9,0.000076,0.006031
742397759991480320,742397759991480320,,1,6,7,1,6,7,7,0.310036,0.344564,0.000002,9,0.000076,0.029235
2755564035,2755564035,,1,1,2,1,1,2,7,0.283203,0.300698,0,9,0.000076,0.004809
909862448391491584,909862448391491584,,1,0,1,1,0,1,0,0,0,0,15,0.000076,0
3631495096,3631495096,,2,0,2,2,0,2,0,0,0,0,13,0.000076,0
1063284314,1063284314,,1,3,4,1,3,4,6,0.365202,0.407508,0.000007,15,0.000076,0.009057
1448571327493951488,1448571327493951488,,1,1,2,1,1,2,7,0.283203,0.300698,0,9,0.000076,0.004809
4832414692,4832414692,,1,0,1,1,0,1,0,0,0,0,15,0.000076,0
1291958281,1291958281,,1,0,1,1,0,1,0,0,0,0,15,0.000076,0
2876249524,2876249524,,1,7,8,1,11,12,10,0.223557,0.262371,0.00002,110,0.000076,0.023755
778693643976581120,778693643976581120,,1,2,3,1,2,3,2,0.75,0.833333,0,15,0.000076,0.018204
1427207768772124672,1427207768772124672,,1,2,3,1,2,3,8,0.239871,0.254935,0.000028,250,0.000076,0.021188
946023379,946023379,,1,2,3,1,2,3,2,0.75,0.833333,0.000001,15,0.000076,0.020787
1042178539745947648,1042178539745947648,,1,1,2,1,1,2,2,0.666667,0.75,0,5,0.000076,0.020692
2196258063,2196258063,,1,0,1,1,0,1,0,0,0,0,15,0.000076,0
2300213626,2300213626,,1,1,2,1,1,2,1,1,1,0,9,0.000076,0.000943
1410625642773811200,1410625642773811200,,1,3,4,1,3,4,7,0.330445,0.365219,0.000004,9,0.000076,0.009907
1280072716893200384,1280072716893200384,,1,0,1,1,0,1,0,0,0,0,15,0.000076,0
1181188050233286656,1181188050233286656,,1,0,1,1,0,1,0,0,0,0,15,0.000076,0
463722316,463722316,,1,0,1,1,0,1,0,0,0,0,15,0.000076,0
495090591,495090591,,1,0,1,1,0,1,0,0,0,0,15,0.000076,0
1298528549591224320,1298528549591224320,,1,2,3,1,3,4,6,0.391245,0.431469,0.000003,9,0.000076,0.004153
1854556328,1854556328,,1,0,1,1,0,1,0,0,0,0,15,0.000076,0
1431187217876127744,1431187217876127744,,1,2,3,1,2,3,7,0.272672,0.305848,0.000004,18,0.000076,0.002155
1433431231320920064,1433431231320920064,,1,1,2,1,1,2,2,0.666667,0.75,0,5,0.000076,0.020692
927989992084910080,927989992084910080,,1,2,3,1,2,3,2,0.6,0.666667,0.000002,57,0.000076,0.020938
828027900372905984,828027900372905984,,1,1,2,1,1,2,7,0.283203,0.300698,0,9,0.000076,0.004809
1890600458,1890600458,,1,1,2,1,3,4,2,0.666667,0.75,0,13,0.000076,0.017924
2942486068,2942486068,,1,0,1,1,0,1,0,0,0,0,15,0.000076,0
1166401156492464128,1166401156492464128,,1,2,3,1,2,3,8,0.303546,0.34345,0.000003,9,0.000076,0.025483
2316346309,2316346309,,1,1,2,1,1,2,8,0.270277,0.295281,0.000005,13,0.000076,0.002146
2323083546,2323083546,,1,3,4,1,3,4,5,0.385463,0.422857,0.000006,110,0.000076,0.00434
1646281124,1646281124,,1,1,2,1,1,2,5,0.425926,0.455797,0.000002,15,0.000076,0.00159
929076034791763968,929076034791763968,,1,4,5,1,5,6,8,0.249724,0.26957,0.000005,14,0.000076,0.003087
1425721067474235392,1425721067474235392,,2,2,4,2,2,4,7,0.285396,0.31824,0.000035,14,0.000111,0.004281
823379509,823379509,,1,0,1,1,0,1,0,0,0,0,15,0.000076,0
1438929994860859392,1438929994860859392,,1,0,1,1,0,1,0,0,0,0,15,0.000076,0
1447511980605120512,1447511980605120512,,1,0,1,1,0,1,0,0,0,0,15,0.000076,0
468720469,468720469,,1,4,5,1,4,5,8,0.277871,0.30837,0.000007,15,0.000076,0.02181
3424465270,3424465270,,1,7,8,1,7,8,9,0.279714,0.349273,0.000012,9,0.000076,0.018275
1429096741945716736,1429096741945716736,,1,4,5,1,4,5,7,0.330836,0.366213,0.000003,9,0.000076,0.048216
937026685211496448,937026685211496448,,1,1,2,1,1,2,6,0.390411,0.429474,0.000002,9,0.000076,0.00415
1326286523801640960,1326286523801640960,,1,2,3,1,2,3,6,0.312775,0.337559,0.000001,15,0.000076,0.02071
962457526435565568,962457526435565568,,1,1,2,1,1,2,8,0.303216,0.342457,0.000003,9,0.000076,0.00479
482752072,482752072,,1,1,2,1,1,2,2,0.666667,0.75,0,15,0.000076,0.017924
812530066978701312,812530066978701312,,1,0,1,1,0,1,0,0,0,0,15,0.000076,0
862970692958138368,862970692958138368,,1,1,2,1,1,2,2,0.666667,0.75,0,5,0.000076,0.020692
1256304262155505664,1256304262155505664,,1,0,1,1,0,1,0,0,0,0,15,0.000076,0
2806077372,2806077372,,2,2,4,2,2,4,5,0.436709,0.469082,0.000011,18,0.000087,0.019514
1079515672177242112,1079515672177242112,,1,0,1,1,0,1,0,0,0,0,15,0.000076,0
1077116208,1077116208,,1,1,2,1,1,2,1,1,1,0,13,0.000076,0.000584
392197028,392197028,,1,2,3,1,2,3,4,0.45,0.546296,0.000001,15,0.000076,0.00056
1403075126481113088,1403075126481113088,,1,1,2,1,1,2,2,0.666667,0.75,0,15,0.000076,0.017924
34570586,34570586,,1,0,1,1,0,1,0,0,0,0,15,0.000076,0
1404723488863227904,1404723488863227904,,1,0,1,1,0,1,0,0,0,0,15,0.000076,0
1016249336903159808,1016249336903159808,,1,4,5,1,4,5,6,0.393487,0.435862,0.000002,37,0.000076,0.030327
2865882423,2865882423,,2,4,6,2,6,8,8,0.270657,0.297016,0.000016,13,0.00008,0.044207
1079788976221966336,1079788976221966336,,2,1,3,2,1,3,8,0.270277,0.295281,0.000026,13,0.000803,0.002146
432566115,432566115,,1,1,2,1,1,2,9,0.208881,0.221934,0,18,0.000076,0.000741
1270030680932712448,1270030680932712448,,1,0,1,1,0,1,0,0,0,0,15,0.000076,0
962439266,962439266,,1,5,6,1,5,6,8,0.235256,0.25103,0.000036,15,0.000076,0.005671
847096890,847096890,,2,0,2,4,0,4,0,0,0,0,13,0.000803,0
1109104534775914496,1109104534775914496,,1,2,3,1,2,3,3,0.555556,0.666667,0.000001,15,0.000076,0.020712
814791853639954432,814791853639954432,,1,0,1,1,0,1,0,0,0,0,15,0.000076,0
2612291988,2612291988,,1,1,2,1,1,2,1,1,1,0,14,0.000076,0.001513
1315234951927869440,1315234951927869440,,1,2,3,1,3,4,2,0.75,0.833333,0,13,0.000076,0.018219
1409857524916969472,1409857524916969472,,1,1,2,1,1,2,4,0.384615,0.483333,0.000001,15,0.000076,0.00007
1166765394977275904,1166765394977275904,,2,0,2,2,0,2,0,0,0,0,13,0.00135,0
1430162268,1430162268,,1,9,10,1,10,11,7,0.31173,0.351312,0.000041,13,0.000076,0.054805
2273516571,2273516571,,1,12,13,1,13,14,9,0.259585,0.31874,0.000021,14,0.000076,0.051949
1207392071306416128,1207392071306416128,,1,0,1,1,0,1,0,0,0,0,15,0.000076,0
1436294611559923712,1436294611559923712,,1,2,3,1,2,3,2,0.625,0.7,0.000001,9,0.000076,0.020759
447439107,447439107,,1,0,1,1,0,1,0,0,0,0,15,0.000076,0
2216051760,2216051760,,2,5,7,4,5,9,6,0.391017,0.435698,0.00001,110,0.000111,0.026511
2766471181,2766471181,,1,0,1,1,0,1,0,0,0,0,15,0.000076,0
598603007,598603007,,1,3,4,1,3,4,2,0.8,0.875,0.000001,37,0.000076,0.021411
1437697795499118592,1437697795499118592,,2,5,7,2,5,7,6,0.362225,0.406567,0.000022,18,0.000111,0.033661
1236379816431169536,1236379816431169536,,1,3,4,1,3,4,6,0.365418,0.408641,0.000007,9,0.000076,0.00921
2504120874,2504120874,,2,3,5,2,4,6,2,0.714286,0.8,0.000002,13,0.000111,0.018105
1000138698032320512,1000138698032320512,,1,2,3,1,2,3,4,0.405797,0.449405,0.000002,15,0.000076,0.003562
63211096,63211096,,1,0,1,1,0,1,0,0,0,0,15,0.000076,0
3103748006,3103748006,,1,0,1,1,0,1,0,0,0,0,15,0.000076,0
969926737361604608,969926737361604608,,1,2,3,1,2,3,7,0.272727,0.306162,0.000003,14,0.000076,0.022827
4707222196,4707222196,,1,0,1,1,0,1,0,0,0,0,15,0.000076,0
1155207979,1155207979,,1,3,4,1,3,4,8,0.270594,0.296582,0.000005,13,0.000076,0.040763
4914915772,4914915772,,1,2,3,1,3,4,2,0.666667,0.75,0,13,0.000076,0.038617
1375749037933137920,1375749037933137920,,1,0,1,1,0,1,0,0,0,0,15,0.000076,0
384516505,384516505,,1,1,2,1,1,2,6,0.390411,0.429474,0.000002,9,0.000076,0.00415
1158758131448590336,1158758131448590336,,1,5,6,1,6,7,5,0.442424,0.4879,0.000005,15,0.000076,0.001882
1123179943037423616,1123179943037423616,,1,2,3,1,3,4,6,0.401198,0.439353,0.000003,15,0.000076,0.00574
716243750,716243750,,1,0,1,1,0,1,0,0,0,0,15,0.000076,0
3103980363,3103980363,,1,0,1,1,0,1,0,0,0,0,15,0.000076,0
2266782874,2266782874,,1,0,1,1,0,1,0,0,0,0,15,0.000076,0
1214986704492339200,1214986704492339200,,1,11,12,1,11,12,6,0.381579,0.426457,0.000009,18,0.000076,0.0167
977194732068790272,977194732068790272,,2,5,7,2,5,7,5,0.386803,0.426471,0.000034,110,0.000087,0.029887
481347189,481347189,,1,0,1,1,0,1,0,0,0,0,15,0.000076,0
405035087,405035087,,1,1,2,1,1,2,1,1,1,0,15,0.000076,0.000155
1249848746,1249848746,,6,29,35,6,46,52,11,0.196548,0.246457,0.00018,19,0.000086,0.000747
2306307694,2306307694,,1,1,2,1,1,2,2,0.666667,0.75,0,15,0.000076,0.017924
708773624,708773624,,1,4,5,1,4,5,8,0.313236,0.355831,0.000008,14,0.000076,0.023276
1401425662401974272,1401425662401974272,,1,9,10,1,13,14,9,0.251422,0.295933,0.000033,15,0.000076,0.006617
1441036749396926464,1441036749396926464,,1,4,5,1,4,5,2,0.75,0.833333,0.000001,15,0.000076,0.039329
20849130,20849130,,1,1,2,1,1,2,6,0.390411,0.429474,0.000002,9,0.000076,0.00415
4307656647,4307656647,,2,4,6,2,5,7,8,0.305313,0.346291,0.000016,13,0.000111,0.023865
971409602091864064,971409602091864064,,1,2,3,1,2,3,9,0.18408,0.196644,0,18,0.000076,0.021662
1369381358322204672,1369381358322204672,,1,0,1,1,0,1,0,0,0,0,15,0.000076,0
1356291950194937856,1356291950194937856,,2,2,4,2,2,4,6,0.391781,0.432051,0.000016,37,0.000079,0.004189
57271548,57271548,,1,1,2,1,1,2,2,0.666667,0.75,0,5,0.000076,0.020692
211254120,211254120,,1,5,6,1,6,7,7,0.287234,0.311849,0.000005,9,0.000076,0.026852
1433902353707675648,1433902353707675648,,1,3,4,1,3,4,2,0.714286,0.8,0.000003,15,0.000076,0.020814
1447517712675184640,1447517712675184640,,1,0,1,1,0,1,0,0,0,0,15,0.000076,0
1241839999345197056,1241839999345197056,,1,1,2,1,2,3,11,0.173163,0.184811,0.000009,15,0.000076,0.000359
1021807586,1021807586,,1,0,1,1,0,1,0,0,0,0,15,0.000076,0
837053957897863168,837053957897863168,,3,3,6,3,3,6,7,0.273342,0.307908,0.000012,15,0.000083,0.02017
1446806699201945600,1446806699201945600,,1,1,2,1,1,2,6,0.390411,0.429474,0.000002,9,0.000076,0.00415
2941915384,2941915384,,1,9,10,1,10,11,11,0.195068,0.223615,0.000016,13,0.000076,0.02364
1435036992056737792,1435036992056737792,,2,1,3,3,1,4,9,0.208881,0.221934,0.000055,15,0.000692,0.000741
909172727537381376,909172727537381376,,1,1,2,1,1,2,2,0.666667,0.75,0,15,0.000076,0.017924
2223326053,2223326053,,1,3,4,1,3,4,11,0.173659,0.186724,0.000013,15,0.000076,0.000543
1450831470604476416,1450831470604476416,,1,0,1,1,0,1,0,0,0,0,15,0.000076,0
1450353177887444992,1450353177887444992,,1,0,1,1,0,1,0,0,0,0,15,0.000076,0
465860666,465860666,,1,2,3,1,2,3,2,0.666667,0.75,0.000001,15,0.000076,0.020766
1089107530247221248,1089107530247221248,,1,5,6,1,6,7,8,0.323314,0.368997,0.000006,13,0.000076,0.028751
1246207771340681216,1246207771340681216,,1,2,3,1,2,3,1,1,1,0,37,0.000076,0.024137
1380861113546510336,1380861113546510336,,1,1,2,1,1,2,1,1,1,0,13,0.000076,0.000132
1432152666835234816,1432152666835234816,,1,4,5,1,4,5,7,0.285714,0.308627,0,9,0.000076,0.044038
45661685,45661685,,1,1,2,1,1,2,1,1,1,0,13,0.000076,0.000132
1707854503,1707854503,,3,10,13,4,10,14,8,0.275854,0.307546,0.000065,15,0.0012,0.043875
1032616751614386176,1032616751614386176,,1,1,2,1,1,2,4,0.421053,0.489583,0,15,0.000076,0.000431
1353988796203884544,1353988796203884544,,2,1,3,3,1,4,1,1,1,0,15,0.000079,0.000584
1217493838731804672,1217493838731804672,,1,3,4,1,3,4,11,0.212517,0.266231,0.000015,15,0.000076,0.006655
135646754,135646754,,1,0,1,1,0,1,0,0,0,0,15,0.000076,0
1319313421423226880,1319313421423226880,,1,1,2,1,1,2,1,1,1,0,17,0.000076,0.000054
4458653776,4458653776,,4,8,12,6,9,15,7,0.332182,0.380105,0.000716,18,0.000173,0.035326
2999932538,2999932538,,1,1,2,1,1,2,2,0.666667,0.75,0,5,0.000076,0.020692
1360341200990068736,1360341200990068736,,1,3,4,1,3,4,6,0.362076,0.40543,0.000006,18,0.000076,0.00991
4160203479,4160203479,,1,10,11,1,11,12,9,0.230338,0.263972,0.000006,15,0.000076,0.050588
2363670784,2363670784,,2,9,11,2,11,13,7,0.341381,0.388813,0.000162,14,0.000727,0.027687
999280766,999280766,,1,2,3,1,2,3,7,0.284872,0.304319,0.000001,21,0.000076,0.00492
985333405,985333405,,1,5,6,1,6,7,11,0.147869,0.154731,0.000005,15,0.000076,0.000084
2387298926,2387298926,,1,6,7,1,6,7,9,0.2418,0.282246,0.000028,13,0.000076,0.00459
914924414332014592,914924414332014592,,1,3,4,1,3,4,5,0.441341,0.475105,0.000003,19,0.000076,0.022378
1423246370597752832,1423246370597752832,,2,1,3,2,1,3,6,0.390411,0.429474,0.000033,18,0.000097,0.00415
955143768889536512,955143768889536512,,1,2,3,1,2,3,2,0.75,0.833333,0,15,0.000076,0.020803
1353069759852474368,1353069759852474368,,1,0,1,1,0,1,0,0,0,0,15,0.000076,0
1271122621128683520,1271122621128683520,,3,3,6,3,3,6,8,0.246523,0.262657,0.000077,18,0.000403,0.021252
465921722,465921722,,1,6,7,1,7,8,9,0.243031,0.280489,0.00002,14,0.000076,0.02393
2436608759,2436608759,,4,4,8,4,4,8,7,0.330836,0.366213,0.000047,9,0.000747,0.031234
65458287,65458287,,1,0,1,1,0,1,0,0,0,0,15,0.000076,0
1252252773917380608,1252252773917380608,,1,0,1,1,0,1,0,0,0,0,15,0.000076,0
949280015652413440,949280015652413440,,3,10,13,3,11,14,8,0.247514,0.26681,0.000126,13,0.000728,0.039475
3296497990,3296497990,,1,0,1,1,0,1,0,0,0,0,15,0.000076,0
701168995,701168995,,1,1,2,1,1,2,1,1,1,0,15,0.000076,0.000108
1241472625785942016,1241472625785942016,,1,1,2,1,1,2,2,0.666667,0.75,0.000001,15,0.000076,0.000074
1362739364,1362739364,,1,1,2,2,1,3,2,0.666667,0.75,0,15,0.000076,0.017924
827257022068371456,827257022068371456,,1,0,1,1,0,1,0,0,0,0,15,0.000076,0
860491562152755200,860491562152755200,,1,0,1,1,0,1,0,0,0,0,15,0.000076,0
899162146705166336,899162146705166336,,1,0,1,1,0,1,0,0,0,0,15,0.000076,0
41094956,41094956,,0,1,1,0,1,1,1,1,1,0,28,0,0.000022
2234580853,2234580853,,0,2,2,0,2,2,7,0.27339,0.306524,0,14,0,0.00225
29164139,29164139,,0,1,1,0,1,1,1,1,1,0,28,0,0.000022
30890619,30890619,,0,2,2,0,2,2,1,1,1,0,28,0,0.000023
1426157994,1426157994,,0,2,2,0,2,2,5,0.450575,0.473129,0,28,0,0.000067
627128494,627128494,,0,1,1,0,1,1,3,0.428571,0.5,0,25,0,0
1439115904529350656,1439115904529350656,,0,0,0,0,0,0,0,0,0,0,24,0,0
1017005305,1017005305,,0,1,1,0,1,1,3,0.428571,0.5,0,25,0,0
3246463853,3246463853,,1,0,1,2,0,2,0,0,0,0,25,0.000001,0
270839361,270839361,,9,3,12,14,6,20,1,1,1,0.000029,25,0.001218,0
775433035525357568,775433035525357568,,0,1,1,0,1,1,1,1,1,0,28,0,0.000022
929043015003525120,929043015003525120,,0,0,0,0,0,0,0,0,0,0,26,0,0
2685370465,2685370465,,1,0,1,2,0,2,0,0,0,0,9,0,0
1322279007996514304,1322279007996514304,,1,0,1,1,0,1,0,0,0,0,9,0,0
1431288829319827456,1431288829319827456,,1,2,3,1,2,3,6,0.391245,0.431469,0.000005,9,0,0.005093
1418218357472460800,1418218357472460800,,1,0,1,1,0,1,0,0,0,0,9,0,0
1301552882563645440,1301552882563645440,,1,0,1,1,0,1,0,0,0,0,9,0,0
2811019933,2811019933,,1,0,1,2,0,2,0,0,0,0,9,0,0
201761137,201761137,,0,1,1,0,1,1,1,1,1,0,28,0,0.000022
1257959892,1257959892,,0,1,1,0,1,1,1,1,1,0,28,0,0.000022
1281480546082861056,1281480546082861056,,0,1,1,0,1,1,1,1,1,0,28,0,0.000022
131467551,131467551,,0,1,1,0,1,1,1,1,1,0,28,0,0.000022
1513338074,1513338074,,4,3,7,4,4,8,3,0.545455,0.611111,0.000012,13,0.001501,0.018325
364485678,364485678,,0,5,5,0,5,5,5,0.452463,0.477131,0,28,0,0.000091
1009420195012792320,1009420195012792320,,8,0,8,8,0,8,0,0,0,0,28,0.000005,0
4908665781,4908665781,,0,1,1,0,1,1,1,1,1,0,28,0,0.000022
455571736,455571736,,0,1,1,0,1,1,1,1,1,0,28,0,0.000022
1191956201011105792,1191956201011105792,,0,1,1,0,1,1,1,1,1,0,28,0,0.000022
414143168,414143168,,0,1,1,0,1,1,1,1,1,0,28,0,0.000022
264318097,264318097,,0,1,1,0,1,1,1,1,1,0,28,0,0.000022
1178340480,1178340480,,0,1,1,0,1,1,1,1,1,0,28,0,0.000022
50966558,50966558,,0,1,1,0,1,1,1,1,1,0,28,0,0.000022
3164390831,3164390831,,0,1,1,0,1,1,1,1,1,0,28,0,0.000022
764086857235886080,764086857235886080,,0,1,1,0,1,1,1,1,1,0,28,0,0.000022
554309481,554309481,,0,1,1,0,1,1,1,1,1,0,28,0,0.000022
1425115142413504512,1425115142413504512,,0,1,1,0,1,1,1,1,1,0,28,0,0.000022
1412540145778180096,1412540145778180096,,0,1,1,0,1,1,1,1,1,0,28,0,0.000022
4090373373,4090373373,,0,1,1,0,1,1,1,1,1,0,28,0,0.000022
1253714305750650880,1253714305750650880,,0,1,1,0,1,1,1,1,1,0,28,0,0.000022
51182604,51182604,,0,3,3,0,3,3,1,1,1,0,28,0,0.000044
714481631113953280,714481631113953280,,7,0,7,7,0,7,0,0,0,0,28,0.000009,0
1243205836253659136,1243205836253659136,,0,1,1,0,1,1,1,1,1,0,28,0,0.000022
142711432,142711432,,0,1,1,0,1,1,1,1,1,0,28,0,0.000022
1415199168,1415199168,,0,2,2,0,2,2,5,0.450575,0.473129,0,28,0,0.000067
1386751423,1386751423,,0,2,2,0,2,2,1,1,1,0,33,0,0.000051
1117415327615397888,1117415327615397888,,0,2,2,0,2,2,2,0.535714,0.566667,0,57,0,0.000025
1410114999138373632,1410114999138373632,,0,2,2,0,2,2,5,0.450575,0.473129,0,28,0,0.000067
464954800,464954800,,0,1,1,0,1,1,1,1,1,0,28,0,0.000022
179049222,179049222,,0,1,1,0,1,1,1,1,1,0,28,0,0.000022
1514301510,1514301510,,0,1,1,0,1,1,1,1,1,0,28,0,0.000022
402890008,402890008,,0,1,1,0,1,1,1,1,1,0,28,0,0.000022
420429428,420429428,,0,1,1,0,1,1,1,1,1,0,28,0,0.000022
457477405,457477405,,0,1,1,0,1,1,1,1,1,0,28,0,0.000022
481046302,481046302,,0,1,1,0,1,1,1,1,1,0,28,0,0.000022
1181037534157185024,1181037534157185024,,0,1,1,0,1,1,1,1,1,0,28,0,0.000022
1330447615046062080,1330447615046062080,,0,1,1,0,1,1,1,1,1,0,28,0,0.000022
999024747513106432,999024747513106432,,0,1,1,0,1,1,1,1,1,0,28,0,0.000022
1517065688,1517065688,,0,1,1,0,1,1,1,1,1,0,28,0,0.000022
1428354376532336640,1428354376532336640,,0,1,1,0,1,1,1,1,1,0,28,0,0.000022
1262291116663201792,1262291116663201792,,0,2,2,0,2,2,1,1,1,0,28,0,0.000044
2895667397,2895667397,,0,1,1,0,1,1,1,1,1,0,28,0,0.000022
473383185,473383185,,0,1,1,0,1,1,1,1,1,0,28,0,0.000022
2941270353,2941270353,,0,1,1,0,1,1,10,0.167137,0.182104,0,18,0,0.000016
113050526,113050526,,0,2,2,0,2,2,3,0.457143,0.489583,0,28,0,0.000057
887576396,887576396,,0,1,1,0,1,1,1,1,1,0,28,0,0.000022
777976098,777976098,,0,1,1,0,1,1,1,1,1,0,28,0,0.000022
1082986110429683712,1082986110429683712,,0,14,14,0,15,15,6,0.330409,0.35,0,28,0,0.000022
379347952,379347952,,1,2,3,1,2,3,3,0.457143,0.489583,0,28,0.000001,0.000036
1435206324715929600,1435206324715929600,,1,0,1,1,0,1,0,0,0,0,28,0.000001,0
745207130207170560,745207130207170560,,1,1,2,1,1,2,2,0.666667,0.75,0,28,0.000001,0.00002
318713537,318713537,,1,2,3,1,2,3,2,0.75,0.833333,0,28,0.000001,0.000021
1006439924701245440,1006439924701245440,,1,0,1,1,0,1,0,0,0,0,28,0.000001,0
1208797459415207936,1208797459415207936,,1,9,10,1,10,11,5,0.45379,0.480282,0.000003,28,0.000001,0.0001
194979957,194979957,,1,0,1,1,0,1,0,0,0,0,28,0.000001,0
780443497,780443497,,1,0,1,1,0,1,0,0,0,0,28,0.000001,0
131502557,131502557,,1,2,3,1,2,3,1,1,1,0,28,0.000001,0.000023
869873746559062016,869873746559062016,,1,1,2,2,1,3,2,0.666667,0.75,0,28,0.000001,0.00002
985142934726160384,985142934726160384,,2,0,2,2,0,2,0,0,0,0,28,0.000001,0
427694799,427694799,,1,2,3,1,2,3,7,0.247113,0.261109,0,28,0.000001,0.000001
2479620311,2479620311,,1,4,5,1,4,5,5,0.452244,0.476166,0.000003,28,0.000001,0.000087
2224402028,2224402028,,0,0,0,0,0,0,0,0,0,0,27,0,0
1306691233,1306691233,,0,1,1,0,1,1,1,1,1,0,28,0,0.000022
845293766843994112,845293766843994112,,0,1,1,0,1,1,1,1,1,0,28,0,0.000022
1370649655135121408,1370649655135121408,,0,8,8,0,15,15,2,0.9,0.944444,0,28,0,0.000022
1296808989305577472,1296808989305577472,,2,0,2,4,0,4,0,0,0,0,28,0.000001,0
715258373,715258373,,1,1,2,2,1,3,1,1,1,0,28,0.000001,0.000022
1393826588,1393826588,,1,1,2,2,1,3,1,1,1,0,28,0.000001,0.000022
1318585057,1318585057,,1,1,2,2,1,3,1,1,1,0,28,0.000001,0.000022
282821474,282821474,,1,2,3,2,2,4,1,1,1,0,28,0.000001,0.000023
2172140190,2172140190,,1,2,3,2,2,4,1,1,1,0,28,0.000001,0.000023
1623361106,1623361106,,1,1,2,2,1,3,1,1,1,0,28,0.000001,0.000001
1561431264,1561431264,,0,1,1,0,1,1,1,1,1,0,28,0,0.000022
983993474,983993474,,0,1,1,0,1,1,1,1,1,0,28,0,0.000022
743870977,743870977,,0,1,1,0,1,1,1,1,1,0,28,0,0.000022
1338439037791690752,1338439037791690752,,0,2,2,0,2,2,1,1,1,0,28,0,0.000024
330349571,330349571,,67,0,67,67,0,67,0,0,0,0,28,0.000088,0
469822688,469822688,,0,1,1,0,1,1,1,1,1,0,28,0,0.000022
2319258554,2319258554,,0,1,1,0,1,1,1,1,1,0,28,0,0.000022
3426991144,3426991144,,0,1,1,0,1,1,1,1,1,0,28,0,0.000022
956902544126693376,956902544126693376,,0,1,1,0,1,1,1,1,1,0,28,0,0.000022
1544336527,1544336527,,0,6,6,0,6,6,5,0.453196,0.478505,0,28,0,0.000068
1347749274,1347749274,,4,0,4,4,0,4,0,0,0,0,28,0.000002,0
1055359790019461120,1055359790019461120,,4,0,4,4,0,4,0,0,0,0,28,0.000005,0
1169859545864134656,1169859545864134656,,5,1,6,6,1,7,1,1,1,0,28,0.000005,0
1039048494,1039048494,,0,3,3,0,3,3,4,0.463415,0.530702,0,28,0,0.000026
979376632434778112,979376632434778112,,1,0,1,1,0,1,0,0,0,0,28,0.000001,0
484070006,484070006,,0,1,1,0,1,1,1,1,1,0,28,0,0.000022
2938682115,2938682115,,0,1,1,0,1,1,1,1,1,0,28,0,0.000022
1708149085,1708149085,,0,1,1,0,1,1,1,1,1,0,28,0,0.000022
1349095858894155776,1349095858894155776,,0,4,4,0,4,4,8,0.239829,0.264605,0,14,0,0.002196
1032691285,1032691285,,0,5,5,0,5,5,5,0.450526,0.474805,0,28,0,0.000088
258861907,258861907,,20,0,20,20,0,20,0,0,0,0,28,0.000008,0
2754565029,2754565029,,0,4,4,0,4,4,5,0.451945,0.475865,0,28,0,0.000069
2730965728,2730965728,,4,1,5,4,1,5,2,0.666667,0.75,0,28,0.000007,0
1000835549870075904,1000835549870075904,,2,0,2,2,0,2,0,0,0,0,28,0.000003,0
370073560,370073560,,0,2,2,0,2,2,1,1,1,0,33,0,0.000051
92626603,92626603,,0,1,1,0,1,1,1,1,1,0,28,0,0.000022
846458517624119296,846458517624119296,,0,2,2,0,2,2,8,0.225601,0.240073,0,9,0,0.020917
2369237809,2369237809,,0,1,1,0,1,1,1,1,1,0,28,0,0.000022
2293978036,2293978036,,0,1,1,0,1,1,1,1,1,0,28,0,0.000022
521601785,521601785,,0,1,1,0,1,1,1,1,1,0,28,0,0.000022
407103873,407103873,,0,1,1,0,1,1,1,1,1,0,28,0,0.000022
988479725692735488,988479725692735488,,0,2,2,0,2,2,5,0.450575,0.473129,0,28,0,0.000067
491678369,491678369,,0,1,1,0,1,1,1,1,1,0,28,0,0.000022
1857779947,1857779947,,0,1,1,0,1,1,1,1,1,0,28,0,0.000022
255596950,255596950,,0,2,2,0,2,2,1,1,1,0,28,0,0.000022
1417886264892837888,1417886264892837888,,1,0,1,1,0,1,0,0,0,0,28,0.000001,0
252585311,252585311,,0,1,1,0,1,1,1,1,1,0,28,0,0.000022
1202375064,1202375064,,0,1,1,0,1,1,1,1,1,0,28,0,0.000022
702690830,702690830,,0,1,1,0,1,1,1,1,1,0,28,0,0.000022
164324529,164324529,,0,3,3,0,4,4,6,0.322364,0.33051,0,28,0,0.000022
2267806358,2267806358,,2,0,2,4,0,4,0,0,0,0,28,0.000001,0
776159898849648640,776159898849648640,,1,6,7,1,6,7,5,0.472406,0.487812,0.000007,28,0.000001,0.000084
1032957709514158080,1032957709514158080,,0,1,1,0,1,1,1,1,1,0,28,0,0.000022
2348367012,2348367012,,0,1,1,0,1,1,1,1,1,0,28,0,0.000022
2918263197,2918263197,,0,1,1,0,1,1,1,1,1,0,28,0,0.000022
4793622923,4793622923,,0,1,1,0,1,1,1,1,1,0,28,0,0.000022
629285115,629285115,,0,1,1,0,1,1,1,1,1,0,28,0,0.000022
62554246,62554246,,0,1,1,0,1,1,1,1,1,0,28,0,0.000022
705459189225811968,705459189225811968,,0,1,1,0,1,1,1,1,1,0,28,0,0.000022
899738342849478656,899738342849478656,,0,1,1,0,1,1,1,1,1,0,28,0,0.000022
53341132,53341132,,0,1,1,0,1,1,1,1,1,0,28,0,0.000022
2752353844,2752353844,,0,1,1,0,1,1,1,1,1,0,28,0,0.000022
311662324,311662324,,0,1,1,0,1,1,1,1,1,0,28,0,0.000022
198175715,198175715,,0,1,1,0,1,1,1,1,1,0,28,0,0.000022
898234030012985344,898234030012985344,,0,1,1,0,1,1,1,1,1,0,28,0,0.000022
1170382579922612224,1170382579922612224,,0,3,3,0,3,3,1,1,1,0,28,0,0.000045
1015881252912627712,1015881252912627712,,0,3,3,0,3,3,5,0.451613,0.47483,0,28,0,0.000068
961899658481106944,961899658481106944,,2,1,3,2,1,3,4,0.402778,0.439655,0.000001,25,0.000291,0.00037
1093211256964726784,1093211256964726784,,9,0,9,9,0,9,0,0,0,0,18,0.003109,0
3426504598,3426504598,,0,5,5,0,5,5,10,0.210313,0.238168,0,13,0,0.018879
2470692079,2470692079,,0,2,2,0,2,2,5,0.450575,0.473129,0,28,0,0.000068
884419459,884419459,,0,1,1,0,1,1,1,1,1,0,28,0,0.000022
1322247103,1322247103,,0,2,2,0,2,2,1,1,1,0,28,0,0.000044
1035312538798440448,1035312538798440448,,0,1,1,0,1,1,1,1,1,0,28,0,0.000022
1166388701301215232,1166388701301215232,,0,1,1,0,1,1,1,1,1,0,28,0,0.000022
82837121,82837121,,0,1,1,0,1,1,1,1,1,0,28,0,0.000022
161349845,161349845,,0,2,2,0,3,3,2,0.75,0.833333,0,28,0,0.000022
1272570747039428608,1272570747039428608,,1,1,2,2,1,3,1,1,1,0,28,0.000001,0
1242779555527614464,1242779555527614464,,0,2,2,0,2,2,1,1,1,0,28,0,0.000044
389648868,389648868,,0,1,1,0,1,1,1,1,1,0,28,0,0.000022
2591980856,2591980856,,0,1,1,0,1,1,1,1,1,0,28,0,0.000022
484798350,484798350,,0,1,1,0,1,1,1,1,1,0,28,0,0.000022
960483077624664064,960483077624664064,,0,1,1,0,1,1,1,1,1,0,28,0,0.000022
1343666550394511360,1343666550394511360,,0,1,1,0,8,8,9,0.226483,0.249538,0,13,0,0.000237
1027827002911469568,1027827002911469568,,0,1,1,0,1,1,1,1,1,0,28,0,0.000022
1266634908,1266634908,,0,5,5,0,5,5,8,0.270453,0.296249,0,14,0,0.006856
934809157055799296,934809157055799296,,0,5,5,0,7,7,2,0.857143,0.916667,0,15,0,0.000165
1009225098,1009225098,,1,0,1,2,0,2,0,0,0,0,15,0.000005,0
391602980,391602980,,12,0,12,12,0,12,0,0,0,0,28,0.00001,0
2609773355,2609773355,,0,1,1,0,1,1,1,1,1,0,28,0,0.000022
2328729294,2328729294,,0,1,1,0,1,1,1,1,1,0,28,0,0.000022
840831695477694464,840831695477694464,,0,2,2,0,2,2,10,0.205369,0.225643,0,13,0,0.017961
600136789,600136789,,0,1,1,0,2,2,9,0.200489,0.210853,0,14,0,0.000112
1392963879286759424,1392963879286759424,,0,1,1,0,1,1,1,1,1,0,28,0,0.000022
2070321,2070321,,0,1,1,0,1,1,1,1,1,0,28,0,0.000022
452305279,452305279,,0,1,1,0,1,1,1,1,1,0,28,0,0.000022
2444792134,2444792134,,0,1,1,0,1,1,1,1,1,0,28,0,0.000022
2308322319,2308322319,,0,1,1,0,1,1,1,1,1,0,28,0,0.000022
2455783342,2455783342,,0,3,3,0,3,3,1,1,1,0,28,0,0.000044
510874656,510874656,,1,0,1,1,0,1,0,0,0,0,28,0.000001,0
464945603,464945603,,0,1,1,0,1,1,1,1,1,0,28,0,0.000022
1154698531,1154698531,,0,2,2,0,2,2,1,1,1,0,14,0,0.000056
1427645059428765696,1427645059428765696,,3,0,3,5,0,5,0,0,0,0,14,0.000094,0
736151871572869120,736151871572869120,,5,0,5,5,0,5,0,0,0,0,14,0.001838,0
811510373329371136,811510373329371136,,0,1,1,0,1,1,1,1,1,0,28,0,0.000022
45697545,45697545,,0,2,2,0,3,3,3,0.461538,0.583333,0,21,0,0
35259388,35259388,,1,0,1,2,0,2,0,0,0,0,21,0,0
847888050239807488,847888050239807488,,1,1,2,1,2,3,2,0.571429,0.625,0,21,0,0.000019
2168813293,2168813293,,0,1,1,0,1,1,1,1,1,0,28,0,0.000022
1056094116,1056094116,,9,4,13,10,5,15,1,1,1,0.000006,14,0.002859,0
1189700984,1189700984,,0,1,1,0,1,1,1,1,1,0,28,0,0.000022
915837859462094848,915837859462094848,,0,1,1,0,1,1,1,1,1,0,28,0,0.000022
981843302432608256,981843302432608256,,0,2,2,0,2,2,8,0.262124,0.278251,0,5,0,0.000266
177164070,177164070,,6,11,17,6,13,19,7,0.354409,0.39343,0.000067,18,0.000785,0.0331
831901413169045504,831901413169045504,,0,2,2,0,2,2,5,0.450575,0.473129,0,28,0,0.000068
269361922,269361922,,0,1,1,0,1,1,1,1,1,0,28,0,0.000022
3246056727,3246056727,,0,4,4,0,4,4,9,0.212132,0.228382,0,9,0,0.004779
1038909791966572544,1038909791966572544,,0,3,3,0,3,3,8,0.246456,0.262472,0,14,0,0.002057
4134285383,4134285383,,0,7,7,0,8,8,7,0.327547,0.373974,0,14,0,0.008785
147543162,147543162,,1,0,1,2,0,2,0,0,0,0,14,0.000257,0
1419672928472477696,1419672928472477696,,3,0,3,3,0,3,0,0,0,0,14,0.001536,0
1280566146,1280566146,,0,3,3,0,5,5,9,0.219679,0.235876,0,14,0,0.001101
462808763,462808763,,0,1,1,0,1,1,1,1,1,0,28,0,0.000022
44404321,44404321,,0,1,1,0,1,1,1,1,1,0,28,0,0.000022
960936291314659328,960936291314659328,,0,1,1,0,1,1,1,1,1,0,28,0,0.000022
1732285082,1732285082,,0,1,1,0,1,1,1,1,1,0,28,0,0.000022
600717502,600717502,,0,1,1,0,1,1,1,1,1,0,28,0,0.000022
1443698557022883840,1443698557022883840,,4,0,4,4,0,4,0,0,0,0,18,0.000701,0
321885054,321885054,,0,1,1,0,1,1,1,1,1,0,28,0,0.000022
522216700,522216700,,0,1,1,0,1,1,1,1,1,0,28,0,0.000022
1040828736,1040828736,,0,3,3,0,3,3,8,0.247645,0.280616,0,9,0,0.005259
251307101,251307101,,0,2,2,0,2,2,1,1,1,0,57,0,0.000057
815169029681856512,815169029681856512,,21,0,21,21,0,21,0,0,0,0,57,0.001191,0
1139423655983587328,1139423655983587328,,0,1,1,0,1,1,1,1,1,0,28,0,0.000022
1635661050,1635661050,,0,2,2,0,2,2,1,1,1,0,28,0,0.000023
2326570649,2326570649,,0,1,1,0,1,1,1,1,1,0,28,0,0.000022
545395545,545395545,,0,2,2,0,2,2,1,1,1,0,28,0,0.000022
1009429105220177920,1009429105220177920,,4,1,5,5,2,7,2,0.666667,0.75,0,9,0.001137,0.000111
429967445,429967445,,1,2,3,1,2,3,2,0.75,0.833333,0,9,0.000001,0.021635
2908509497,2908509497,,1,4,5,1,5,6,6,0.394631,0.436735,0.000026,14,0.000001,0.009226
200415822,200415822,,1,1,2,1,1,2,7,0.283203,0.300698,0.000001,9,0.000001,0.004809
2234769152,2234769152,,1,5,6,1,5,6,4,0.44186,0.552632,0.000008,9,0.000001,0.018083
3433016405,3433016405,,0,1,1,0,1,1,1,1,1,0,28,0,0.000022
2572528525,2572528525,,0,1,1,0,1,1,1,1,1,0,28,0,0.000022
2162738143,2162738143,,0,2,2,0,2,2,1,1,1,0,28,0,0.000022
1210270235594506240,1210270235594506240,,6,0,6,6,0,6,0,0,0,0,28,0.000004,0
2785274194,2785274194,,0,1,1,0,1,1,1,1,1,0,28,0,0.000022
3137282110,3137282110,,0,1,1,0,1,1,1,1,1,0,28,0,0.000022
2956358817,2956358817,,0,6,6,0,6,6,5,0.452222,0.477396,0,28,0,0.000069
476013124,476013124,,16,0,16,17,0,17,0,0,0,0,28,0.000011,0
1078759935914242048,1078759935914242048,,1,7,8,1,7,8,6,0.316078,0.332961,0,28,0.000002,0.00006
316578097,316578097,,0,1,1,0,1,1,1,1,1,0,28,0,0.000022
915566532,915566532,,0,1,1,0,1,1,1,1,1,0,28,0,0.000022
273056277,273056277,,0,1,1,0,1,1,1,1,1,0,28,0,0.000022
1180151189364711424,1180151189364711424,,0,1,1,0,1,1,1,1,1,0,28,0,0.000022
2803860044,2803860044,,0,6,6,0,7,7,7,0.317073,0.361965,0,9,0,0.017711
16393904,16393904,,0,1,1,0,1,1,1,1,1,0,28,0,0.000022
995229176344072192,995229176344072192,,1,0,1,1,0,1,0,0,0,0,14,0.001517,0
1346756418,1346756418,,0,3,3,0,3,3,5,0.450913,0.474177,0,28,0,0.000046
3285268147,3285268147,,0,1,1,0,1,1,1,1,1,0,28,0,0.000022
701509209372938240,701509209372938240,,0,1,1,0,1,1,1,1,1,0,28,0,0.000022
499934461,499934461,,0,1,1,0,1,1,1,1,1,0,28,0,0.000022
401568347,401568347,,0,5,5,0,6,6,5,0.453704,0.478231,0,28,0,0.000099
483456206,483456206,,0,1,1,0,1,1,9,0.219895,0.234924,0,18,0,0.000116
838693075,838693075,,0,1,1,0,1,1,1,1,1,0,28,0,0.000022
1379837293,1379837293,,0,1,1,0,1,1,1,1,1,0,28,0,0.000022
22188018,22188018,,0,1,1,0,1,1,9,0.200489,0.210853,0,14,0,0.000112
86716636,86716636,,0,2,2,0,2,2,6,0.312936,0.32368,0,28,0,0.000022
793367160341094400,793367160341094400,,1,6,7,1,7,8,5,0.453829,0.478825,0.000006,28,0.000001,0.000069
2508991900,2508991900,,0,1,1,0,1,1,1,1,1,0,28,0,0.000022
1241680211650973696,1241680211650973696,,0,1,1,0,1,1,1,1,1,0,28,0,0.000022
60408021,60408021,,0,1,1,0,1,1,1,1,1,0,28,0,0.000022
372220527,372220527,,0,5,5,0,5,5,5,0.452874,0.477496,0,28,0,0.000069
757584344273780736,757584344273780736,,3,0,3,3,0,3,0,0,0,0,28,0.000002,0
220793612,220793612,,2,0,2,2,0,2,0,0,0,0,28,0.000002,0
1645224056,1645224056,,0,1,1,0,1,1,1,1,1,0,28,0,0.000022
3399075250,3399075250,,0,5,5,0,5,5,5,0.453917,0.477834,0,28,0,0.000071
1220516591139479552,1220516591139479552,,1,0,1,1,0,1,0,0,0,0,9,0.000528,0
1055220536521953280,1055220536521953280,,1,4,5,1,5,6,3,0.55,0.651515,0.000005,21,0.000528,0.000973
391521149,391521149,,0,1,1,0,1,1,1,1,1,0,28,0,0.000022
398048066,398048066,,0,1,1,0,1,1,1,1,1,0,28,0,0.000022
475094197,475094197,,0,1,1,0,1,1,1,1,1,0,28,0,0.000022
457397432,457397432,,0,2,2,0,2,2,1,1,1,0,28,0,0.000024
722931043578310656,722931043578310656,,0,1,1,0,1,1,1,1,1,0,28,0,0.000022
1616066779,1616066779,,0,1,1,0,1,1,1,1,1,0,28,0,0.000022
121756913,121756913,,0,6,6,0,7,7,10,0.200953,0.260055,0,28,0,0.000073
14287772,14287772,,1,4,5,1,4,5,9,0.194312,0.203826,0.000015,28,0.000002,0
2744419310,2744419310,,9,0,9,10,0,10,0,0,0,0,110,0.00004,0
30680085,30680085,,0,1,1,0,1,1,1,1,1,0,28,0,0.000022
227606688,227606688,,0,1,1,0,1,1,1,1,1,0,28,0,0.000022
237711602,237711602,,0,1,1,0,1,1,1,1,1,0,28,0,0.000022
1363569958500851712,1363569958500851712,,0,1,1,0,1,1,1,1,1,0,28,0,0.000022
38406846,38406846,,0,1,1,0,1,1,1,1,1,0,28,0,0.000022
1602804482,1602804482,,8,3,11,13,6,19,1,1,1,0.000049,21,0.00066,0.000028
1375889374760558592,1375889374760558592,,0,1,1,0,1,1,1,1,1,0,28,0,0.000022
15098203,15098203,,0,1,1,0,1,1,1,1,1,0,28,0,0.000022
987344071,987344071,,0,1,1,0,1,1,1,1,1,0,28,0,0.000022
808215598488489984,808215598488489984,,0,3,3,0,5,5,5,0.474576,0.48733,0,28,0,0.000103
595356862,595356862,,0,1,1,0,1,1,1,1,1,0,28,0,0.000022
1063158360,1063158360,,0,1,1,0,1,1,1,1,1,0,28,0,0.000022
2578058312,2578058312,,0,1,1,0,1,1,1,1,1,0,28,0,0.000022
3350975284,3350975284,,0,1,1,0,1,1,1,1,1,0,28,0,0.000022
2343512623,2343512623,,0,1,1,0,1,1,1,1,1,0,28,0,0.000022
499581721,499581721,,0,1,1,0,1,1,1,1,1,0,28,0,0.000022
888268895341035520,888268895341035520,,0,3,3,0,3,3,8,0.227206,0.244175,0,9,0,0.000451
1406197037029265408,1406197037029265408,,0,3,3,0,3,3,5,0.45122,0.47412,0,28,0,0.000072
807957044753997824,807957044753997824,,0,1,1,0,1,1,1,1,1,0,28,0,0.000022
2302151496,2302151496,,0,1,1,0,1,1,1,1,1,0,28,0,0.000022
859388930,859388930,,0,1,1,0,1,1,1,1,1,0,28,0,0.000022
83913925,83913925,,0,4,4,0,4,4,11,0.189949,0.225358,0,19,0,0.020902
1421861875768348672,1421861875768348672,,1,0,1,1,0,1,0,0,0,0,19,0.000611,0
564497761,564497761,,0,4,4,0,5,5,3,0.472222,0.506536,0,28,0,0.000058
1413730903,1413730903,,8,15,23,9,16,25,2,0.894737,0.941176,0.000003,33,0.000002,0
470454408,470454408,,0,2,2,0,2,2,1,1,1,0,28,0,0.000025
407833309,407833309,,0,1,1,0,1,1,1,1,1,0,28,0,0.000022
431553037,431553037,,0,1,1,0,1,1,1,1,1,0,28,0,0.000022
1445013694593830912,1445013694593830912,,0,1,1,0,1,1,1,1,1,0,28,0,0
1412670347095293952,1412670347095293952,,3,0,3,3,0,3,0,0,0,0,28,0,0
1060935332160565248,1060935332160565248,,0,2,2,0,2,2,1,1,1,0,250,0,0.000022
1093522737241513984,1093522737241513984,,4,0,4,5,0,5,0,0,0,0,250,0.000001,0
1198625838075432960,1198625838075432960,,0,1,1,0,1,1,1,1,1,0,28,0,0.000022
22693775,22693775,,0,3,3,0,3,3,2,0.551724,0.59375,0,57,0,0.000029
799886914807590912,799886914807590912,,0,1,1,0,1,1,1,1,1,0,28,0,0.000022
973373467,973373467,,4,6,10,4,6,10,2,0.8,0.875,0.000001,28,0.000006,0
23985428,23985428,,1,0,1,1,0,1,0,0,0,0,28,0.000003,0
55339886,55339886,,0,1,1,0,1,1,1,1,1,0,57,0,0.000082
1292463168166526976,1292463168166526976,,0,3,3,0,3,3,6,0.272048,0.296429,0,57,0,0.000117
816046986952605696,816046986952605696,,0,1,1,0,1,1,1,1,1,0,28,0,0.000022
1362438933066448896,1362438933066448896,,0,3,3,0,3,3,1,1,1,0,28,0,0.000023
1013954305,1013954305,,0,5,5,0,5,5,5,0.434224,0.465831,0,28,0,0.000069
510448863,510448863,,0,1,1,0,1,1,1,1,1,0,28,0,0.000022
881039666035675136,881039666035675136,,0,3,3,0,3,3,8,0.283855,0.303057,0,18,0,0.001507
2347151255,2347151255,,0,2,2,0,3,3,1,1,1,0,28,0,0.000022
440896943,440896943,,0,1,1,0,1,1,9,0.219895,0.234924,0,18,0,0.000116
797374091959406592,797374091959406592,,0,1,1,0,1,1,9,0.200489,0.210853,0,14,0,0.000112
4823282043,4823282043,,0,2,2,0,2,2,11,0.162175,0.174645,0,206,0,0.001522
17340424,17340424,,0,1,1,0,1,1,1,1,1,0,28,0,0.000022
1097126775036018688,1097126775036018688,,0,1,1,0,1,1,1,1,1,0,28,0,0.000022
269387968,269387968,,0,1,1,0,1,1,1,1,1,0,28,0,0.000022
972879120446246912,972879120446246912,,0,2,2,0,2,2,1,1,1,0,28,0,0.000023
765223257972871168,765223257972871168,,0,1,1,0,1,1,1,1,1,0,28,0,0.000022
3423687117,3423687117,,0,1,1,0,1,1,1,1,1,0,28,0,0.000022
237256441,237256441,,0,1,1,0,1,1,1,1,1,0,28,0,0.000022
2489774295,2489774295,,0,1,1,0,1,1,1,1,1,0,28,0,0.000022
2732751986,2732751986,,0,6,6,0,6,6,8,0.305512,0.3356,0,15,0,0.004156
459446024,459446024,,0,1,1,0,1,1,1,1,1,0,28,0,0.000022
1001006498082934784,1001006498082934784,,0,1,1,0,1,1,1,1,1,0,28,0,0.000022
555355980,555355980,,0,1,1,0,1,1,1,1,1,0,28,0,0.000022
13728662,13728662,,0,1,1,0,1,1,8,0.261897,0.277405,0,18,0,0.000023
1015661811700510720,1015661811700510720,,0,1,1,0,1,1,1,1,1,0,28,0,0.000022
396835780,396835780,,0,1,1,0,1,1,1,1,1,0,28,0,0.000022
1010600056582492160,1010600056582492160,,0,2,2,0,2,2,1,1,1,0,28,0,0.000022
1035698683,1035698683,,17,0,17,17,0,17,0,0,0,0,28,0.000011,0
373962173,373962173,,0,1,1,0,1,1,1,1,1,0,28,0,0.000022
833727093959696384,833727093959696384,,0,1,1,0,1,1,1,1,1,0,28,0,0.000022
801062327810461696,801062327810461696,,0,1,1,0,1,1,1,1,1,0,28,0,0.000022
995206019662925824,995206019662925824,,0,1,1,0,1,1,1,1,1,0,28,0,0.000022
462427721,462427721,,0,5,5,0,5,5,5,0.475087,0.489106,0,28,0,0.000107
434743018,434743018,,1,2,3,1,4,5,1,1,1,0,28,0.000003,0
912000926826815488,912000926826815488,,0,4,4,0,4,4,1,1,1,0,28,0,0.000082
1209960722408628224,1209960722408628224,,1,0,1,1,0,1,0,0,0,0,28,0.000002,0
4251035097,4251035097,,0,1,1,0,1,1,1,1,1,0,28,0,0.000022
981069865,981069865,,0,2,2,0,2,2,1,1,1,0,28,0,0.000022
527763534,527763534,,2,0,2,2,0,2,0,0,0,0,28,0.000002,0
510323032,510323032,,0,3,3,0,3,3,1,1,1,0,28,0,0.000024
2283375104,2283375104,,0,2,2,0,2,2,3,0.5,0.566667,0,28,0,0.000022
457889747,457889747,,0,1,1,0,1,1,2,0.666667,0.75,0,5,0,0.020692
1183449929907343360,1183449929907343360,,0,3,3,0,3,3,3,0.527778,0.570175,0,28,0,0.000023
1319900551363108864,1319900551363108864,,0,1,1,0,1,1,1,1,1,0,28,0,0.000022
3194573930,3194573930,,0,3,3,0,3,3,2,0.8,0.875,0,28,0,0.000022
1194797988,1194797988,,0,0,0,0,0,0,0,0,0,0,29,0,0
2268796084,2268796084,,0,2,2,0,2,2,4,0.430769,0.479167,0,14,0,0.000159
1437347457336332288,1437347457336332288,,0,2,2,0,3,3,9,0.19981,0.210768,0,14,0,0.000054
46879002,46879002,,0,1,1,0,1,1,1,1,1,0,28,0,0.000022
972052104591364096,972052104591364096,,0,1,1,0,1,1,1,1,1,0,28,0,0.000022
3124682311,3124682311,,0,1,1,0,1,1,1,1,1,0,28,0,0.000022
1448678983718080512,1448678983718080512,,0,0,0,0,0,0,0,0,0,0,30,0,0
1073355817,1073355817,,0,2,2,0,2,2,5,0.450575,0.473129,0,28,0,0.000068
759717599328411648,759717599328411648,,0,2,2,0,2,2,1,1,1,0,28,0,0.000022
1434038420,1434038420,,0,1,1,0,1,1,1,1,1,0,28,0,0.000022
895467806,895467806,,0,1,1,0,1,1,1,1,1,0,28,0,0.000022
898851116145946624,898851116145946624,,0,1,1,0,1,1,1,1,1,0,28,0,0.000022
913062474,913062474,,0,3,3,0,3,3,3,0.527778,0.570175,0,28,0,0.000023
2212635263,2212635263,,6,0,6,6,0,6,0,0,0,0,28,0.000006,0
1106654538512154624,1106654538512154624,,0,3,3,0,4,4,6,0.39427,0.435352,0,13,0,0.004201
1385897613329903616,1385897613329903616,,3,2,5,4,3,7,1,1,1,0.000001,13,0.00109,0.000613
858298730281406464,858298730281406464,,2,2,4,3,2,5,1,1,1,0,13,0.000669,0.003448
1380163632,1380163632,,0,7,7,0,7,7,6,0.273863,0.301916,0,28,0,0.000464
2996281582,2996281582,,9,0,9,9,0,9,0,0,0,0,28,0.000025,0
1325189458069577728,1325189458069577728,,1,0,1,1,0,1,0,0,0,0,28,0.000014,0
1447626752424038400,1447626752424038400,,1,0,1,2,0,2,0,0,0,0,15,0.000002,0
1397862635220213760,1397862635220213760,,1,0,1,1,0,1,0,0,0,0,15,0.000002,0
25508589,25508589,,1,0,1,1,0,1,0,0,0,0,15,0.000002,0
97722177,97722177,,0,1,1,0,1,1,1,1,1,0,28,0,0.000022
1131689516601888768,1131689516601888768,,0,1,1,0,1,1,1,1,1,0,28,0,0.000022
2590303014,2590303014,,0,0,0,0,0,0,0,0,0,0,31,0,0
1181965797553520640,1181965797553520640,,0,0,0,0,0,0,0,0,0,0,32,0,0
419755092,419755092,,0,4,4,0,4,4,11,0.194222,0.237083,0,15,0,0.011452
4764696798,4764696798,,0,8,8,0,9,9,8,0.236866,0.252704,0,18,0,0.022245
1164281046,1164281046,,1,0,1,2,0,2,0,0,0,0,18,0.00065,0
1450099033888989184,1450099033888989184,,1,0,1,1,0,1,0,0,0,0,18,0.00065,0
4228626766,4228626766,,1,0,1,1,0,1,0,0,0,0,18,0.00065,0
1440284732688797696,1440284732688797696,,1,2,3,1,2,3,1,1,1,0,18,0.00065,0.000585
2464236962,2464236962,,0,1,1,0,1,1,1,1,1,0,28,0,0.000022
1347594260263088128,1347594260263088128,,0,1,1,0,1,1,1,1,1,0,28,0,0.000022
1209056792107503616,1209056792107503616,,0,1,1,0,1,1,1,1,1,0,28,0,0.000022
547776393,547776393,,0,1,1,0,1,1,1,1,1,0,28,0,0.000022
1302659042402336768,1302659042402336768,,0,4,4,0,4,4,10,0.221513,0.272348,0,18,0,0.00007
454423746,454423746,,12,0,12,13,0,13,0,0,0,0,18,0.000008,0
2834853891,2834853891,,1,0,1,1,0,1,0,0,0,0,37,0,0
331005596,331005596,,2,0,2,2,0,2,0,0,0,0,37,0,0
1374198374,1374198374,,0,1,1,0,1,1,1,1,1,0,28,0,0.000022
2252146516,2252146516,,0,2,2,0,2,2,5,0.450575,0.473129,0,28,0,0.000068
2172508827,2172508827,,0,5,5,0,5,5,9,0.205859,0.219082,0,18,0,0.022159
434736878,434736878,,0,1,1,0,1,1,1,1,1,0,28,0,0.000022
942662407171735552,942662407171735552,,0,1,1,0,1,1,1,1,1,0,28,0,0
215976090,215976090,,0,5,5,0,5,5,1,1,1,0,33,0,0.000054
791056984468549632,791056984468549632,,5,0,5,5,0,5,0,0,0,0,33,0.000005,0
1085291572588097536,1085291572588097536,,0,2,2,0,2,2,2,0.75,0.833333,0,28,0,0.000042
4069859405,4069859405,,0,1,1,0,1,1,1,1,1,0,28,0,0.000022
2189012053,2189012053,,0,2,2,0,2,2,1,1,1,0,28,0,0.000022
1256869652686348288,1256869652686348288,,0,1,1,0,1,1,1,1,1,0,28,0,0.000022
1104138512205561856,1104138512205561856,,0,1,1,0,1,1,1,1,1,0,28,0,0.000022
977982478240673792,977982478240673792,,0,2,2,0,2,2,5,0.450575,0.473129,0,28,0,0.000068
504713946,504713946,,0,2,2,0,3,3,2,0.625,0.7,0,25,0,0.000036
1534117524,1534117524,,1,0,1,2,0,2,0,0,0,0,25,0.000001,0
2647427506,2647427506,,0,1,1,0,1,1,1,1,1,0,28,0,0.000022
48140019,48140019,,0,1,1,0,1,1,1,1,1,0,28,0,0.000022
1011490686783442944,1011490686783442944,,0,1,1,0,1,1,1,1,1,0,28,0,0.000022
947835841665228800,947835841665228800,,0,1,1,0,1,1,1,1,1,0,28,0,0.000022
990363276,990363276,,0,1,1,0,1,1,1,1,1,0,28,0,0.000022
96853674,96853674,,0,2,2,0,2,2,5,0.450575,0.473129,0,28,0,0.000068
2656984642,2656984642,,0,2,2,0,2,2,8,0.23577,0.251228,0,14,0,0.000608
468571956,468571956,,0,3,3,0,3,3,11,0.194036,0.236372,0,15,0,0.006643
1448920258446872576,1448920258446872576,,0,3,3,0,3,3,4,0.463415,0.530702,0,28,0,0.000028
1627102968,1627102968,,0,1,1,0,1,1,1,1,1,0,28,0,0.000022
1317907940,1317907940,,0,2,2,0,2,2,9,0.219638,0.23559,0,18,0,0.01841
1255327982425722880,1255327982425722880,,0,1,1,0,1,1,2,0.666667,0.75,0,13,0,0.017924
1260236809709260800,1260236809709260800,,0,2,2,0,2,2,1,1,1,0,28,0,0.000022
107517248,107517248,,4,2,6,6,4,10,2,0.75,0.833333,0.000001,206,0.000614,0.000005
2749765771,2749765771,,1,0,1,2,0,2,0,0,0,0,206,0.000613,0
52424550,52424550,,2,1,3,8,2,10,2,0.533333,0.5625,0.000003,206,0.000613,0
484982241,484982241,,2,0,2,4,0,4,0,0,0,0,206,0.000613,0
826769015976636416,826769015976636416,,1,0,1,1,0,1,0,0,0,0,206,0.000613,0
1006493750,1006493750,,0,4,4,0,5,5,11,0.173326,0.186034,0,13,0,0.020739
1242637958559211520,1242637958559211520,,0,1,1,0,1,1,1,1,1,0,28,0,0.000022
904374802743427072,904374802743427072,,2,15,17,2,15,17,7,0.32209,0.364391,0.000225,15,0.001337,0.030117
1180252686,1180252686,,0,1,1,0,1,1,1,1,1,0,28,0,0.000022
3310422237,3310422237,,0,1,1,0,1,1,1,1,1,0,28,0,0.000022
886056563378708480,886056563378708480,,0,2,2,0,2,2,6,0.391542,0.431707,0,9,0,0.004167
476235682,476235682,,0,1,1,0,1,1,1,1,1,0,28,0,0.000022
1432462898,1432462898,,0,1,1,0,1,1,9,0.205166,0.21661,0,15,0,0.000162
464855487,464855487,,0,5,5,0,5,5,11,0.173487,0.186586,0,14,0,0.000534
1050870285736521728,1050870285736521728,,4,0,4,4,0,4,0,0,0,0,14,0.002033,0
473786130,473786130,,3,0,3,3,0,3,0,0,0,0,14,0.000016,0
517457983,517457983,,3,0,3,4,0,4,0,0,0,0,14,0.000643,0
1260995011493146624,1260995011493146624,,1,1,2,2,1,3,2,0.666667,0.75,0,15,0,0.020692
31107308,31107308,,0,1,1,0,1,1,1,1,1,0,28,0,0.000022
986140489,986140489,,1,3,4,1,3,4,2,0.8,0.875,0.000001,15,0.000003,0.001015
2545771164,2545771164,,1,0,1,1,0,1,0,0,0,0,15,0.000003,0
1123858502118776832,1123858502118776832,,1,4,5,1,6,7,6,0.358854,0.394458,0.000033,13,0.000003,0.029658
1260886282483400704,1260886282483400704,,1,0,1,1,0,1,0,0,0,0,15,0.000003,0
4204183834,4204183834,,1,4,5,1,5,6,8,0.304049,0.345012,0.000023,5,0.000003,0.025546
993093173261094912,993093173261094912,,1,0,1,1,0,1,0,0,0,0,15,0.000003,0
952247125185720320,952247125185720320,,2,4,6,2,5,7,1,1,1,0.000004,15,0.000809,0.001522
2842808602,2842808602,,1,2,3,1,3,4,8,0.270467,0.296004,0.000037,13,0.000003,0.022838
2378380248,2378380248,,0,3,3,0,3,3,4,0.463415,0.530702,0,28,0,0.000026
3995707457,3995707457,,6,0,6,6,0,6,0,0,0,0,28,0.000001,0
1462785926,1462785926,,0,2,2,0,2,2,5,0.450575,0.473129,0,28,0,0.000068
1025430856918347776,1025430856918347776,,0,1,1,0,1,1,11,0.173163,0.184811,0,15,0,0.000359
2337369724,2337369724,,0,1,1,0,1,1,1,1,1,0,28,0,0.000022
1369173655,1369173655,,0,2,2,0,2,2,4,0.45,0.50463,0,28,0,0.000026
632742781,632742781,,0,3,3,0,3,3,5,0.451206,0.47447,0,28,0,0.000046
515229378,515229378,,1,0,1,1,0,1,0,0,0,0,28,0.000001,0
488895138,488895138,,0,2,2,0,2,2,3,0.5,0.555556,0,28,0,0.000022
1091990374401359872,1091990374401359872,,0,1,1,0,1,1,1,1,1,0,28,0,0.000022
512463968,512463968,,0,1,1,0,1,1,1,1,1,0,28,0,0.000022
252128466,252128466,,0,1,1,0,1,1,11,0.173163,0.184811,0,15,0,0.000359
1448028416800956416,1448028416800956416,,1,1,2,1,2,3,1,1,1,0.000001,21,0.001153,0.000001
1734989120,1734989120,,1,0,1,1,0,1,0,0,0,0,13,0.001153,0
737129292811866112,737129292811866112,,6,15,21,6,21,27,6,0.315056,0.354966,0.00005,110,0.002973,0.007494
457700602,457700602,,1,1,2,1,2,3,1,1,1,0.000001,21,0.001153,0
13167392,13167392,,0,1,1,0,1,1,6,0.390411,0.429474,0,9,0,0.00415
1244249856413179904,1244249856413179904,,2,6,8,2,6,8,4,0.467532,0.539352,0.000007,15,0.000912,0.01998
1347491738,1347491738,,2,0,2,2,0,2,0,0,0,0,15,0.000796,0
422042010,422042010,,0,1,1,0,1,1,1,1,1,0,28,0,0.000022
1365596789433335808,1365596789433335808,,0,1,1,0,1,1,1,1,1,0,28,0,0.000022
2218220468,2218220468,,0,1,1,0,1,1,1,1,1,0,28,0,0.000022
111696944,111696944,,0,8,8,0,9,9,6,0.428784,0.462232,0,28,0,0.000104
406912789,406912789,,6,0,6,6,0,6,0,0,0,0,28,0.000004,0
1246917715941634048,1246917715941634048,,0,2,2,0,2,2,11,0.173222,0.185265,0,15,0,0.018283
39240661,39240661,,0,4,4,0,6,6,5,0.451835,0.475804,0,28,0,0.000086
15446820,15446820,,2,0,2,3,0,3,0,0,0,0,28,0.00053,0
812266128877686784,812266128877686784,,0,1,1,0,1,1,1,1,1,0,28,0,0.000022
2784413707,2784413707,,0,2,2,0,2,2,3,0.5,0.555556,0,28,0,0.000022
1011308525807693824,1011308525807693824,,0,3,3,0,3,3,1,1,1,0,28,0,0.000023
3239016405,3239016405,,9,0,9,9,0,9,0,0,0,0,28,0.000001,0
1428365919667982336,1428365919667982336,,1,0,1,1,0,1,0,0,0,0,14,0,0
1952714982,1952714982,,1,0,1,1,0,1,0,0,0,0,14,0,0
2967886973,2967886973,,1,3,4,1,3,4,2,0.8,0.875,0,14,0,0.020381
2411225194,2411225194,,1,0,1,1,0,1,0,0,0,0,14,0,0
96337794,96337794,,1,2,3,1,2,3,5,0.450575,0.473129,0.000102,14,0,0.000046
2438340445,2438340445,,1,1,2,1,1,2,1,1,1,0,14,0,0
1492509740,1492509740,,1,3,4,1,5,6,7,0.28646,0.312328,0.000073,14,0,0.008468
504172561,504172561,,1,0,1,1,0,1,0,0,0,0,14,0,0
337187902,337187902,,1,0,1,1,0,1,0,0,0,0,14,0,0
219361447,219361447,,1,1,2,1,1,2,1,1,1,0,57,0,0.000035
1159393215855976448,1159393215855976448,,1,3,4,1,4,5,7,0.272895,0.307288,0.000011,14,0,0.00374
3032346760,3032346760,,1,0,1,1,0,1,0,0,0,0,14,0,0
260895340,260895340,,1,0,1,1,0,1,0,0,0,0,14,0,0
1450919237179031552,1450919237179031552,,1,0,1,1,0,1,0,0,0,0,14,0,0
26219337,26219337,,1,2,3,1,2,3,2,0.666667,0.75,0,14,0,0.038617
858460695138009088,858460695138009088,,0,1,1,0,1,1,2,0.666667,0.75,0,15,0,0.000142
1046093769328726016,1046093769328726016,,2,1,3,2,2,4,1,1,1,0,13,0.000002,0.000584
61567461,61567461,,3,0,3,3,0,3,0,0,0,0,28,0.000002,0
454173647,454173647,,1,0,1,2,0,2,0,0,0,0,15,0.000732,0
977300186279137280,977300186279137280,,0,3,3,0,3,3,1,1,1,0,18,0,0.000061
1292194878,1292194878,,1,1,2,2,2,4,1,1,1,0.000001,110,0.000972,0.000023
1047918328747048960,1047918328747048960,,4,0,4,4,0,4,0,0,0,0,13,0.00227,0
2876346088,2876346088,,0,2,2,0,2,2,3,0.5,0.555556,0,28,0,0.000022
1422950364932890624,1422950364932890624,,6,0,6,6,0,6,0,0,0,0,9,0.00171,0
3860196976,3860196976,,1,5,6,1,9,10,2,0.857143,0.916667,0.000004,13,0.000134,0.018261
1088921400050634752,1088921400050634752,,0,4,4,0,4,4,10,0.208896,0.233378,0,110,0,0.021446
3253796020,3253796020,,2,0,2,2,0,2,0,0,0,0,110,0.00143,0
720547596,720547596,,0,1,1,0,1,1,2,0.666667,0.75,0,13,0,0.017924
821879334,821879334,,0,6,6,0,6,6,11,0.17355,0.187116,0,15,0,0.024271
79211525,79211525,,6,1,7,6,1,7,1,1,1,0.00001,15,0.003257,0
29201900,29201900,,0,9,9,0,10,10,9,0.244278,0.295008,0,13,0,0.057056
1080150091825061888,1080150091825061888,,0,11,11,0,13,13,5,0.474923,0.492708,0,28,0,0.00013
1057566882780323840,1057566882780323840,,0,0,0,0,0,0,0,0,0,0,34,0,0
1448760214971469824,1448760214971469824,,0,0,0,0,0,0,0,0,0,0,35,0,0
697097599078240256,697097599078240256,,0,1,1,0,1,1,1,1,1,0,17,0,0
406263339,406263339,,5,0,5,5,0,5,0,0,0,0,17,0.000012,0
839726317,839726317,,0,1,1,0,1,1,1,1,1,0,28,0,0.000022
57620125,57620125,,0,1,1,0,1,1,1,1,1,0,28,0,0.000022
870707147444584448,870707147444584448,,0,1,1,0,1,1,1,1,1,0,28,0,0.000022
1438546161955229696,1438546161955229696,,2,1,3,2,1,3,10,0.20915,0.234986,0.000003,15,0.000561,0.000353
1258458493360771072,1258458493360771072,,1,0,1,1,0,1,0,0,0,0,15,0.000367,0
287281772,287281772,,0,1,1,0,1,1,1,1,1,0,28,0,0.000022
1160335674224128000,1160335674224128000,,5,0,5,5,0,5,0,0,0,0,15,0.001228,0
1413875742140686336,1413875742140686336,,0,5,5,0,5,5,6,0.39779,0.440914,0,13,0,0.02852
1373354712460886016,1373354712460886016,,1,1,2,1,1,2,1,1,1,0,15,0,0.003445
221535008,221535008,,0,1,1,0,1,1,4,0.46875,0.491667,0,14,0,0.001002
1254692512817647616,1254692512817647616,,0,0,0,0,0,0,0,0,0,0,36,0,0
1032326690264018944,1032326690264018944,,3,1,4,3,1,4,1,1,1,0.000002,15,0.002344,0
313314510,313314510,,0,1,1,0,1,1,1,1,1,0,28,0,0.000022
726673795,726673795,,0,4,4,0,4,4,8,0.248455,0.273365,0,13,0,0.002921
398293985,398293985,,3,3,6,3,3,6,7,0.266899,0.286,0.000024,13,0.000813,0.017975
997465047675932672,997465047675932672,,0,1,1,0,1,1,9,0.219895,0.234924,0,18,0,0.000116
838888350287282176,838888350287282176,,0,1,1,0,1,1,1,1,1,0,28,0,0.000022
2498393796,2498393796,,0,1,1,0,1,1,4,0.384615,0.483333,0,15,0,0.00007
897729421,897729421,,0,1,1,0,1,1,2,0.571429,0.625,0,110,0,0.000006
18935802,18935802,,5,3,8,9,6,15,1,1,1,0.000007,110,0.000217,0
419622371,419622371,,5,0,5,9,0,9,0,0,0,0,13,0.000023,0
1149014184,1149014184,,0,2,2,0,2,2,9,0.219991,0.235381,0,18,0,0.01804
390032884,390032884,,8,1,9,8,1,9,1,1,1,0,37,0.001335,0.00029
4702133172,4702133172,,0,1,1,0,1,1,1,1,1,0,28,0,0.000022
1416544094453698560,1416544094453698560,,0,1,1,0,1,1,1,1,1,0,28,0,0
908107531,908107531,,2,2,4,2,3,5,2,0.625,0.7,0.000024,21,0.001576,0.000019
3719734875,3719734875,,0,2,2,0,5,5,8,0.239914,0.254998,0,13,0,0.01842
463635153,463635153,,0,2,2,0,3,3,9,0.222666,0.239816,0,18,0,0.000116
1858580576,1858580576,,1,2,3,2,2,4,6,0.319654,0.347222,0.000003,18,0.000003,0.006944
2560820463,2560820463,,0,3,3,0,3,3,9,0.219679,0.235876,0,18,0,0.001076
2231771041,2231771041,,3,0,3,3,0,3,0,0,0,0,18,0.000241,0
729339570182066176,729339570182066176,,0,1,1,0,1,1,1,1,1,0,28,0,0
1367413195279904768,1367413195279904768,,0,1,1,0,1,1,1,1,1,0,38,0,0
516664834,516664834,,1,0,1,1,0,1,0,0,0,0,38,0,0
138008505,138008505,,0,2,2,0,2,2,3,0.555556,0.666667,0,13,0,0.018008
1088850380363100160,1088850380363100160,,0,3,3,0,3,3,9,0.250062,0.291804,0,18,0,0.005143
1101507421527252992,1101507421527252992,,0,2,2,0,2,2,1,1,1,0,28,0,0.000001
753300350,753300350,,0,1,1,0,2,2,1,1,1,0,39,0,0
2922532755,2922532755,,1,0,1,2,0,2,0,0,0,0,39,0,0
852336979,852336979,,0,0,0,0,0,0,0,0,0,0,40,0,0
308021144,308021144,,0,0,0,0,0,0,0,0,0,0,41,0,0
252997533,252997533,,1,2,3,1,2,3,9,0.219799,0.236008,0.000012,18,0.000065,0.001456
1229409632,1229409632,,1,1,2,1,1,2,9,0.208881,0.221934,0.000002,18,0.000065,0.000741
221413552,221413552,,1,0,1,1,0,1,0,0,0,0,18,0.000065,0
2155461192,2155461192,,1,7,8,1,8,9,6,0.362237,0.400477,0.000008,13,0.000065,0.052597
529487878,529487878,,2,0,2,2,0,2,0,0,0,0,18,0.000076,0
1420795914797584384,1420795914797584384,,1,0,1,1,0,1,0,0,0,0,18,0.000065,0
4243297695,4243297695,,1,0,1,1,0,1,0,0,0,0,18,0.000065,0
2771279073,2771279073,,1,0,1,1,0,1,0,0,0,0,18,0.000065,0
3194069955,3194069955,,1,0,1,1,0,1,0,0,0,0,18,0.000065,0
1351210649192460288,1351210649192460288,,1,10,11,1,10,11,9,0.274698,0.337819,0.000011,9,0.000065,0.054411
1307727144978706432,1307727144978706432,,1,2,3,1,2,3,7,0.27256,0.305786,0.000003,9,0.000065,0.003078
612793180,612793180,,2,0,2,2,0,2,0,0,0,0,18,0.000076,0
920005244,920005244,,2,10,12,2,14,16,9,0.284076,0.356843,0.000034,13,0.000069,0.058543
598772700,598772700,,1,2,3,1,2,3,9,0.208979,0.222395,0.000003,18,0.000065,0.00079
199620260,199620260,,1,1,2,1,1,2,2,0.666667,0.75,0,18,0.000065,0.017924
1161834389170479104,1161834389170479104,,1,4,5,1,4,5,8,0.258102,0.280649,0.000055,18,0.000065,0.007514
383848053,383848053,,2,0,2,2,0,2,0,0,0,0,18,0.000076,0
1334181428565864448,1334181428565864448,,1,3,4,1,3,4,7,0.286531,0.312473,0,18,0.000065,0.027647
1253009145512497152,1253009145512497152,,2,1,3,2,1,3,6,0.28169,0.320417,0.00001,15,0.000086,0.000083
1319999334025494528,1319999334025494528,,1,1,2,1,1,2,2,0.666667,0.75,0,18,0.000065,0.020692
497714059,497714059,,1,0,1,1,0,1,0,0,0,0,18,0.000065,0
4118365157,4118365157,,1,3,4,1,3,4,8,0.305647,0.346589,0.000007,18,0.000065,0.00553
1314287049634131968,1314287049634131968,,1,6,7,1,6,7,11,0.208294,0.263035,0.000072,13,0.000065,0.0436
1445406745627697152,1445406745627697152,,1,4,5,1,4,5,6,0.362543,0.406418,0.000013,18,0.000065,0.030603
1169515040,1169515040,,0,0,0,0,0,0,0,0,0,0,42,0,0
505111832,505111832,,0,0,0,0,0,0,0,0,0,0,43,0,0
1168983082235551744,1168983082235551744,,0,1,1,0,1,1,1,1,1,0,28,0,0.000022
221102455,221102455,,0,0,0,0,0,0,0,0,0,0,44,0,0
942266220,942266220,,1,2,3,1,2,3,2,0.75,0.833333,0,15,0,0.019393
2852272811,2852272811,,0,2,2,0,2,2,9,0.226578,0.249946,0,18,0,0.000244
1441670407975620608,1441670407975620608,,0,0,0,0,0,0,0,0,0,0,45,0,0
1002865394632314880,1002865394632314880,,1,0,1,1,0,1,0,0,0,0,13,0.000007,0
1356937042488401920,1356937042488401920,,1,0,1,2,0,2,0,0,0,0,13,0.000007,0
308905321,308905321,,2,2,4,2,4,6,3,0.5,0.595238,0.000108,13,0.000531,0.000024
1275414672,1275414672,,3,5,8,3,8,11,2,0.857143,0.916667,0.000013,28,0.00001,0
1349459111251947520,1349459111251947520,,0,6,6,0,6,6,6,0.382128,0.426355,0,18,0,0.006916
459640016,459640016,,1,0,1,1,0,1,0,0,0,0,18,0.000202,0
1301626694890139648,1301626694890139648,,0,3,3,0,3,3,8,0.242724,0.264492,0,15,0,0.002638
353611343,353611343,,1,0,1,1,0,1,0,0,0,0,15,0.000003,0
3052508874,3052508874,,2,1,3,2,1,3,6,0.390411,0.429474,0.000016,15,0.000213,0.00415
1201586449939865600,1201586449939865600,,1,2,3,1,2,3,2,0.75,0.833333,0,15,0.000003,0.021369
1449112830117126144,1449112830117126144,,2,0,2,2,0,2,0,0,0,0,15,0.000809,0
239853957,239853957,,1,0,1,1,0,1,0,0,0,0,15,0.000003,0
971773373499002880,971773373499002880,,3,1,4,3,1,4,1,1,1,0.000001,15,0.000739,0.000279
927640638,927640638,,1,0,1,1,0,1,0,0,0,0,15,0.000003,0
1182035380893339648,1182035380893339648,,0,0,0,0,0,0,0,0,0,0,46,0,0
1149989155604185088,1149989155604185088,,0,3,3,0,3,3,3,0.545455,0.611111,0,17,0,0.000422
1200141713769193472,1200141713769193472,,0,2,2,0,2,2,8,0.303546,0.34345,0,9,0,0.025483
2944916679,2944916679,,0,0,0,0,0,0,0,0,0,0,47,0,0
1149753555840045056,1149753555840045056,,1,1,2,1,1,2,6,0.390411,0.429474,0.000005,21,0,0.00415
84353786,84353786,,1,0,1,1,0,1,0,0,0,0,21,0,0
543703916,543703916,,0,4,4,0,4,4,2,0.833333,0.9,0,18,0,0.020256
287379444,287379444,,0,1,1,0,1,1,1,1,1,0,28,0,0
857261583453630464,857261583453630464,,0,0,0,0,0,0,0,0,0,0,48,0,0
367088923,367088923,,0,0,0,0,0,0,0,0,0,0,49,0,0
115308284,115308284,,0,4,4,0,4,4,5,0.452244,0.476166,0,28,0,0.000107
379828154,379828154,,0,0,0,0,0,0,0,0,0,0,50,0,0
1451523266225573888,1451523266225573888,,0,1,1,0,1,1,9,0.226483,0.249538,0,13,0,0.000237
2601981953,2601981953,,0,3,3,0,4,4,9,0.233667,0.260758,0,13,0,0.00512
2190341129,2190341129,,0,0,0,0,0,0,0,0,0,0,51,0,0
312659733,312659733,,0,0,0,0,0,0,0,0,0,0,52,0,0
55627298,55627298,,0,0,0,0,0,0,0,0,0,0,53,0,0
1364296562332024832,1364296562332024832,,0,1,1,0,1,1,1,1,1,0,18,0,0.00011
3676295055,3676295055,,0,1,1,0,1,1,1,1,1,0,18,0,0.00002
1054832415800246272,1054832415800246272,,0,2,2,0,2,2,4,0.476923,0.508065,0,18,0,0.001022
1055560390720008192,1055560390720008192,,0,1,1,0,1,1,1,1,1,0,28,0,0
1343531349706223616,1343531349706223616,,1,0,1,2,0,2,0,0,0,0,13,0.000727,0
2206599659,2206599659,,1,7,8,1,7,8,6,0.368192,0.412761,0.000025,206,0.000727,0.048123
597566730,597566730,,1,0,1,1,0,1,0,0,0,0,13,0.000727,0
1403020942800982016,1403020942800982016,,1,1,2,5,1,6,2,0.666667,0.75,0,13,0.000727,0.017924
996435287948627968,996435287948627968,,1,1,2,1,1,2,7,0.283203,0.300698,0,13,0.000727,0.004809
2336489501,2336489501,,1,0,1,1,0,1,0,0,0,0,13,0.000727,0
1401942238544990208,1401942238544990208,,1,1,2,1,1,2,6,0.390411,0.429474,0.000012,13,0.000727,0.00415
1345033794529714176,1345033794529714176,,1,0,1,2,0,2,0,0,0,0,13,0.000727,0
3075400845,3075400845,,1,1,2,2,1,3,2,0.666667,0.75,0,13,0.000727,0.017924
876376471224410112,876376471224410112,,1,1,2,1,1,2,1,1,1,0,15,0.000727,0.00011
955839913668247552,955839913668247552,,1,0,1,1,0,1,0,0,0,0,13,0.000727,0
296832232,296832232,,1,1,2,1,1,2,2,0.666667,0.75,0,13,0.000727,0.020692
1297154614467399680,1297154614467399680,,1,2,3,1,2,3,2,0.583333,0.642857,0.000005,13,0.000727,0.017972
1394673329550802944,1394673329550802944,,1,0,1,3,0,3,0,0,0,0,13,0.000727,0
1217767250695946240,1217767250695946240,,1,1,2,1,1,2,2,0.666667,0.75,0,13,0.000727,0.017924
965513960274452480,965513960274452480,,1,0,1,1,0,1,0,0,0,0,13,0.000727,0
133167075,133167075,,1,3,4,1,3,4,8,0.303986,0.344543,0,13,0.000727,0.043407
366581598,366581598,,1,0,1,1,0,1,0,0,0,0,13,0.000727,0
394157019,394157019,,1,1,2,1,2,3,1,1,1,0.000002,14,0.000727,0.000019
1075891609701662720,1075891609701662720,,2,1,3,2,1,3,2,0.666667,0.75,0,13,0.001378,0.020692
1321498864852107264,1321498864852107264,,1,0,1,1,0,1,0,0,0,0,13,0.000727,0
707885009592578048,707885009592578048,,1,1,2,1,2,3,3,0.458333,0.5,0.000003,19,0.000727,0.000096
1330319852242874368,1330319852242874368,,1,0,1,1,0,1,0,0,0,0,13,0.000727,0
1395252659096068096,1395252659096068096,,2,0,2,2,0,2,0,0,0,0,13,0.001378,0
580096126,580096126,,1,1,2,1,1,2,7,0.283203,0.300698,0,13,0.000727,0.004809
849990387255177216,849990387255177216,,1,1,2,1,1,2,2,0.666667,0.75,0,13,0.000727,0.017924
636526571,636526571,,1,2,3,1,2,3,8,0.303655,0.34355,0,13,0.000727,0.022715
424084271,424084271,,4,10,14,4,14,18,6,0.330249,0.366164,0.000058,13,0.00076,0.030876
596355382,596355382,,1,0,1,1,0,1,0,0,0,0,13,0.000727,0
1261557341108961280,1261557341108961280,,1,0,1,1,0,1,0,0,0,0,13,0.000727,0
1400039468455845888,1400039468455845888,,1,2,3,1,2,3,8,0.303546,0.34345,0,13,0.000727,0.025483
846133032,846133032,,1,0,1,1,0,1,0,0,0,0,13,0.000727,0
593817814,593817814,,1,2,3,1,2,3,8,0.303655,0.34355,0,13,0.000727,0.022715
14064380,14064380,,1,0,1,1,0,1,0,0,0,0,13,0.000727,0
1496843330,1496843330,,2,0,2,2,0,2,0,0,0,0,13,0.000762,0
17007782,17007782,,1,1,2,1,1,2,2,0.666667,0.75,0,13,0.000727,0.017924
273897097,273897097,,1,1,2,1,2,3,4,0.46875,0.491667,0.000003,14,0.000727,0.001002
482507306,482507306,,2,1,3,2,1,3,1,1,1,0.000001,18,0.001379,0.000004
1382497897615396864,1382497897615396864,,1,0,1,1,0,1,0,0,0,0,13,0.000727,0
52058037,52058037,,1,0,1,1,0,1,0,0,0,0,13,0.000727,0
1408300345307115520,1408300345307115520,,1,1,2,2,1,3,1,1,1,0,13,0.000727,0.001469
956124344245276672,956124344245276672,,1,0,1,1,0,1,0,0,0,0,13,0.000727,0
484592863,484592863,,2,3,5,2,3,5,1,1,1,0.000003,15,0.000738,0.001639
63715092,63715092,,1,0,1,1,0,1,0,0,0,0,13,0.000727,0
2954518204,2954518204,,2,1,3,2,1,3,2,0.666667,0.75,0,13,0.001378,0.017924
346692486,346692486,,1,3,4,1,4,5,5,0.437126,0.474201,0.000008,110,0.000727,0.001751
492397709,492397709,,1,1,2,1,1,2,2,0.666667,0.75,0,13,0.000727,0.017924
95187021,95187021,,1,0,1,1,0,1,0,0,0,0,13,0.000727,0
3307400673,3307400673,,2,3,5,2,3,5,7,0.28848,0.31125,0.000007,15,0.000738,0.025849
1582981274,1582981274,,1,0,1,1,0,1,0,0,0,0,13,0.000727,0
1432273240567820288,1432273240567820288,,1,0,1,1,0,1,0,0,0,0,13,0.000727,0
722422727630565376,722422727630565376,,2,1,3,2,1,3,2,0.666667,0.75,0,18,0.000748,0.017924
70513763,70513763,,1,0,1,1,0,1,0,0,0,0,13,0.000727,0
1421548410222620672,1421548410222620672,,1,0,1,1,0,1,0,0,0,0,13,0.000727,0
560572487,560572487,,1,3,4,3,3,6,7,0.284457,0.305392,0,13,0.000727,0.023345
2971867924,2971867924,,1,0,1,1,0,1,0,0,0,0,13,0.000727,0
1167143631687434240,1167143631687434240,,1,0,1,1,0,1,0,0,0,0,13,0.000727,0
1421877750735032320,1421877750735032320,,1,2,3,1,2,3,2,0.75,0.833333,0,13,0.000727,0.021369
1381992181276282880,1381992181276282880,,2,1,3,3,1,4,2,0.666667,0.75,0,13,0.000762,0.017924
1241675979929661440,1241675979929661440,,3,3,6,4,3,7,5,0.445087,0.478788,0.000023,110,0.000773,0.022385
484654557,484654557,,1,0,1,1,0,1,0,0,0,0,13,0.000727,0
1150176116373696512,1150176116373696512,,1,1,2,1,2,3,2,0.666667,0.75,0,13,0.000727,0.017924
1000821362225754112,1000821362225754112,,2,6,8,2,6,8,5,0.457831,0.502632,0.000061,28,0.000735,0.021451
1359758912174645248,1359758912174645248,,1,1,2,1,1,2,2,0.666667,0.75,0,13,0.000727,0.020692
2465775372,2465775372,,1,2,3,1,2,3,2,0.666667,0.75,0,13,0.000727,0.038617
2815635649,2815635649,,1,0,1,1,0,1,0,0,0,0,13,0.000727,0
1250443323728429056,1250443323728429056,,1,2,3,1,2,3,1,1,1,0,13,0.000727,0.024137
1053051961321365504,1053051961321365504,,0,8,8,0,13,13,11,0.217594,0.260535,0,21,0,0.000047
121424128,121424128,,2,1,3,6,2,8,1,1,1,0,21,0.000001,0
2859252910,2859252910,,1,0,1,2,0,2,0,0,0,0,21,0.000001,0
1231957350828957696,1231957350828957696,,1,2,3,2,2,4,4,0.469388,0.51087,0,21,0.000001,0.000356
1438224486185292032,1438224486185292032,,1,0,1,1,0,1,0,0,0,0,21,0.000001,0
1000959834,1000959834,,2,1,3,2,1,3,2,0.666667,0.75,0,21,0.000005,0.017924
1013376320481517568,1013376320481517568,,1,0,1,1,0,1,0,0,0,0,21,0.000001,0
2322947462,2322947462,,4,1,5,4,1,5,3,0.458333,0.5,0.000009,19,0.000683,0.000096
1441073314634649600,1441073314634649600,,0,5,5,0,5,5,8,0.272856,0.300643,0,18,0,0.020789
1208291366918328320,1208291366918328320,,0,8,8,0,8,8,8,0.301597,0.361221,0,18,0,0.027842
23057232,23057232,,0,0,0,0,0,0,0,0,0,0,54,0,0
2288712929,2288712929,,0,2,2,0,2,2,1,1,1,0,28,0,0.000002
859867832,859867832,,0,1,1,0,1,1,1,1,1,0,28,0,0.000022
1146288277,1146288277,,0,1,1,0,1,1,3,0.444444,0.5,0,18,0,0.000308
1445103330120904704,1445103330120904704,,0,1,1,0,1,1,2,0.666667,0.75,0,5,0,0.020692
708318936513777664,708318936513777664,,1,0,1,1,0,1,0,0,0,0,15,0.000613,0
30439070,30439070,,3,3,6,3,3,6,7,0.284736,0.305678,0.00001,15,0.000831,0.008533
2815977682,2815977682,,1,0,1,1,0,1,0,0,0,0,15,0.000613,0
1434078813063876608,1434078813063876608,,3,0,3,3,0,3,0,0,0,0,18,0.001264,0
1445619005205610496,1445619005205610496,,1,3,4,1,3,4,9,0.209057,0.22289,0.00001,14,0.000613,0.021452
1255412388255485952,1255412388255485952,,1,2,3,1,2,3,2,0.75,0.833333,0,15,0.000613,0.021305
1435676887603458048,1435676887603458048,,2,7,9,3,10,13,8,0.320022,0.364447,0.000208,13,0.000634,0.049478
1415261845347315712,1415261845347315712,,1,0,1,1,0,1,0,0,0,0,15,0.000613,0
1322859828,1322859828,,1,1,2,1,1,2,4,0.46875,0.491667,0.000001,15,0.000613,0.001002
519417308,519417308,,2,1,3,2,1,3,8,0.303216,0.342457,0.000005,15,0.000616,0.00479
198093342,198093342,,1,0,1,1,0,1,0,0,0,0,15,0.000613,0
1059912873210716160,1059912873210716160,,1,0,1,1,0,1,0,0,0,0,15,0.000613,0
1418985127133261824,1418985127133261824,,1,0,1,1,0,1,0,0,0,0,15,0.000613,0
79770812,79770812,,0,1,1,0,1,1,8,0.210869,0.220691,0,13,0,0.000024
1162426204705697792,1162426204705697792,,1,2,3,1,6,7,2,0.625,0.7,0.000006,206,0.001406,0.000004
833219221,833219221,,1,1,2,1,1,2,1,1,1,0.000001,9,0.000726,0
419441999,419441999,,2,0,2,4,0,4,0,0,0,0,15,0.001434,0
823689986373455872,823689986373455872,,1,0,1,1,0,1,0,0,0,0,15,0.000806,0
1420112600650629120,1420112600650629120,,2,4,6,2,4,6,6,0.320605,0.350187,0.000006,14,0.000982,0.02548
1244902114700255232,1244902114700255232,,1,1,2,1,1,2,7,0.283203,0.300698,0.000002,9,0.000003,0.004809
2286669109,2286669109,,10,8,18,10,8,18,5,0.382353,0.475214,0.000067,15,0.002835,0
285805049,285805049,,0,1,1,0,1,1,1,1,1,0,57,0,0
68161227,68161227,,3,0,3,3,0,3,0,0,0,0,57,0.000001,0
1436667511513223168,1436667511513223168,,0,0,0,0,0,0,0,0,0,0,55,0,0
709987980887384064,709987980887384064,,0,0,0,0,0,0,0,0,0,0,56,0,0
82866940,82866940,,1,0,1,2,0,2,0,0,0,0,5,0.000746,0
1305856982906277888,1305856982906277888,,3,0,3,3,0,3,0,0,0,0,5,0.001423,0
452350565,452350565,,2,0,2,2,0,2,0,0,0,0,13,0.000527,0
2353382138,2353382138,,3,5,8,3,6,9,6,0.362889,0.407251,0.000068,13,0.001197,0.052366
1474251840,1474251840,,1,0,1,1,0,1,0,0,0,0,18,0,0
1241735687369560064,1241735687369560064,,1,0,1,1,0,1,0,0,0,0,18,0,0
576369057,576369057,,1,0,1,1,0,1,0,0,0,0,18,0,0
1069926132231925760,1069926132231925760,,2,0,2,2,0,2,0,0,0,0,18,0.000145,0
1121951191,1121951191,,1,2,3,1,2,3,1,1,1,0.000001,18,0,0.001515
1442589814449078272,1442589814449078272,,1,1,2,1,1,2,1,1,1,0,13,0.000001,0.001513
331617619,331617619,,9,3,12,20,6,26,2,0.714286,0.8,0.000088,110,0.000805,0.00001
358270300,358270300,,1,3,4,1,3,4,7,0.306655,0.336664,0.000004,18,0.000001,0.027091
1214907721197199360,1214907721197199360,,1,0,1,1,0,1,0,0,0,0,9,0,0
1187352000972886016,1187352000972886016,,1,0,1,1,0,1,0,0,0,0,33,0,0
193610209,193610209,,1,0,1,1,0,1,0,0,0,0,33,0,0
2637882316,2637882316,,1,7,8,1,9,10,4,0.459459,0.508578,0.000004,28,0,0.000177
384817266,384817266,,1,0,1,1,0,1,0,0,0,0,33,0,0
429443865,429443865,,1,0,1,1,0,1,0,0,0,0,33,0,0
857118703829348352,857118703829348352,,1,0,1,1,0,1,0,0,0,0,33,0,0
1266646404,1266646404,,1,0,1,1,0,1,0,0,0,0,33,0,0
94956249,94956249,,1,0,1,1,0,1,0,0,0,0,33,0,0
389473754,389473754,,1,0,1,1,0,1,0,0,0,0,33,0,0
345568007,345568007,,1,0,1,1,0,1,0,0,0,0,33,0,0
326009390,326009390,,1,0,1,1,0,1,0,0,0,0,33,0,0
38495686,38495686,,1,1,2,1,1,2,2,0.666667,0.75,0,28,0,0.00002
2885936975,2885936975,,1,0,1,1,0,1,0,0,0,0,33,0,0
1168821785074249728,1168821785074249728,,1,0,1,1,0,1,0,0,0,0,33,0,0
133485233,133485233,,1,0,1,1,0,1,0,0,0,0,33,0,0
2198193816,2198193816,,1,1,2,1,2,3,2,0.666667,0.75,0,33,0,0.000004
1209961669801259008,1209961669801259008,,1,0,1,1,0,1,0,0,0,0,33,0,0
888075391,888075391,,1,0,1,1,0,1,0,0,0,0,33,0,0
110726999,110726999,,1,0,1,1,0,1,0,0,0,0,33,0,0
940931797784899584,940931797784899584,,1,0,1,1,0,1,0,0,0,0,33,0,0
513317840,513317840,,1,0,1,1,0,1,0,0,0,0,33,0,0
703204413150621696,703204413150621696,,1,0,1,1,0,1,0,0,0,0,33,0,0
952834075286495232,952834075286495232,,1,0,1,1,0,1,0,0,0,0,33,0,0
974042578910838784,974042578910838784,,1,0,1,1,0,1,0,0,0,0,33,0,0
808207176,808207176,,1,0,1,1,0,1,0,0,0,0,33,0,0
493870947,493870947,,1,3,4,1,3,4,5,0.451613,0.47483,0.000023,33,0,0.000047
2348699587,2348699587,,1,0,1,1,0,1,0,0,0,0,33,0,0
1449361795198722048,1449361795198722048,,1,0,1,1,0,1,0,0,0,0,33,0,0
2321981176,2321981176,,3,4,7,3,4,7,1,1,1,0.000001,28,0,0.00006
254949751,254949751,,1,0,1,1,0,1,0,0,0,0,33,0,0
934355532403658752,934355532403658752,,1,0,1,1,0,1,0,0,0,0,33,0,0
1261737377636253696,1261737377636253696,,1,0,1,1,0,1,0,0,0,0,33,0,0
1427370629083303936,1427370629083303936,,1,0,1,1,0,1,0,0,0,0,33,0,0
1237456990403792896,1237456990403792896,,1,0,1,1,0,1,0,0,0,0,33,0,0
4743497542,4743497542,,1,0,1,1,0,1,0,0,0,0,33,0,0
553651788,553651788,,1,0,1,1,0,1,0,0,0,0,33,0,0
2202343917,2202343917,,1,0,1,1,0,1,0,0,0,0,33,0,0
506402572,506402572,,1,0,1,1,0,1,0,0,0,0,33,0,0
14743262,14743262,,1,0,1,1,0,1,0,0,0,0,33,0,0
2757394229,2757394229,,1,0,1,1,0,1,0,0,0,0,33,0,0
1349446248416354304,1349446248416354304,,1,0,1,1,0,1,0,0,0,0,33,0,0
1354220778846363648,1354220778846363648,,1,2,3,1,2,3,2,0.625,0.7,0,250,0,0.00006
1170782333747773440,1170782333747773440,,1,0,1,1,0,1,0,0,0,0,33,0,0
974936255669600256,974936255669600256,,1,0,1,1,0,1,0,0,0,0,33,0,0
356449684,356449684,,1,0,1,1,0,1,0,0,0,0,33,0,0
1606477722,1606477722,,1,0,1,1,0,1,0,0,0,0,33,0,0
2266890549,2266890549,,1,0,1,1,0,1,0,0,0,0,33,0,0
273675645,273675645,,1,0,1,1,0,1,0,0,0,0,33,0,0
30950093,30950093,,1,0,1,1,0,1,0,0,0,0,33,0,0
350120520,350120520,,1,0,1,1,0,1,0,0,0,0,33,0,0
389076701,389076701,,1,0,1,1,0,1,0,0,0,0,33,0,0
421077547,421077547,,1,0,1,1,0,1,0,0,0,0,33,0,0
417340367,417340367,,1,0,1,1,0,1,0,0,0,0,33,0,0
1361770980012662784,1361770980012662784,,1,0,1,1,0,1,0,0,0,0,33,0,0
3089756417,3089756417,,1,0,1,1,0,1,0,0,0,0,33,0,0
114764138,114764138,,1,0,1,1,0,1,0,0,0,0,33,0,0
540003981,540003981,,1,0,1,1,0,1,0,0,0,0,33,0,0
1097750745259167744,1097750745259167744,,1,0,1,1,0,1,0,0,0,0,33,0,0
1083424494394462208,1083424494394462208,,1,0,1,1,0,1,0,0,0,0,33,0,0
1215548750711660544,1215548750711660544,,1,0,1,1,0,1,0,0,0,0,33,0,0
180112128,180112128,,1,0,1,1,0,1,0,0,0,0,33,0,0
3301454301,3301454301,,1,0,1,1,0,1,0,0,0,0,33,0,0
843204984,843204984,,1,1,2,1,1,2,2,0.666667,0.75,0,33,0,0
1095344617753591808,1095344617753591808,,1,1,2,1,1,2,1,1,1,0,33,0,0
270501780,270501780,,2,0,2,2,0,2,0,0,0,0,33,0,0
716320265026867200,716320265026867200,,2,1,3,2,1,3,1,1,1,0,28,0,0
293971696,293971696,,1,0,1,1,0,1,0,0,0,0,33,0,0
1344291383306309632,1344291383306309632,,1,0,1,1,0,1,0,0,0,0,33,0,0
215589114,215589114,,1,0,1,1,0,1,0,0,0,0,33,0,0
1274818243493015552,1274818243493015552,,1,0,1,1,0,1,0,0,0,0,33,0,0
1429974884,1429974884,,1,0,1,1,0,1,0,0,0,0,33,0,0
1013654088,1013654088,,2,1,3,2,1,3,1,1,1,0.000008,28,0,0
5924732,5924732,,1,0,1,1,0,1,0,0,0,0,33,0,0
1368706697552920576,1368706697552920576,,1,0,1,1,0,1,0,0,0,0,33,0,0
439503657,439503657,,1,0,1,1,0,1,0,0,0,0,33,0,0
915477968,915477968,,1,0,1,1,0,1,0,0,0,0,33,0,0
22026924,22026924,,1,0,1,1,0,1,0,0,0,0,33,0,0
297979685,297979685,,1,0,1,1,0,1,0,0,0,0,33,0,0
39526154,39526154,,1,0,1,1,0,1,0,0,0,0,33,0,0
101262857,101262857,,1,0,1,1,0,1,0,0,0,0,33,0,0
14966514,14966514,,1,0,1,1,0,1,0,0,0,0,33,0,0
1219616913774518272,1219616913774518272,,1,0,1,1,0,1,0,0,0,0,33,0,0
468279709,468279709,,1,0,1,1,0,1,0,0,0,0,33,0,0
1612826408,1612826408,,1,0,1,1,0,1,0,0,0,0,33,0,0
1016300620410744832,1016300620410744832,,1,0,1,1,0,1,0,0,0,0,33,0,0
3243291935,3243291935,,1,0,1,1,0,1,0,0,0,0,33,0,0
73598124,73598124,,0,2,2,0,2,2,1,1,1,0,57,0,0
959953601589325824,959953601589325824,,5,0,5,5,0,5,0,0,0,0,57,0,0
962692920171270144,962692920171270144,,0,4,4,0,4,4,5,0.452354,0.476227,0,57,0,0.000046
4794414694,4794414694,,4,1,5,4,1,5,1,1,1,0,57,0.000003,0
782928793,782928793,,0,0,0,0,0,0,0,0,0,0,58,0,0
310286420,310286420,,0,0,0,0,0,0,0,0,0,0,59,0,0
958958707840311296,958958707840311296,,0,3,3,0,3,3,4,0.5,0.654762,0,28,0,0.017999
49954018,49954018,,2,1,3,2,2,4,3,0.5,0.611111,0,28,0.000526,0
1437460740621938688,1437460740621938688,,0,3,3,0,3,3,8,0.306599,0.346597,0,14,0,0.025505
206832958,206832958,,2,2,4,2,3,5,4,0.430769,0.479167,0.000001,14,0.000746,0.000153
1448250438566957056,1448250438566957056,,0,1,1,0,1,1,5,0.308511,0.339655,0,14,0,0.000022
3140067088,3140067088,,2,0,2,2,0,2,0,0,0,0,15,0.000166,0
1155785260803723264,1155785260803723264,,1,0,1,2,0,2,0,0,0,0,15,0.000044,0
113591628,113591628,,0,0,0,0,0,0,0,0,0,0,60,0,0
410953066,410953066,,1,0,1,1,0,1,0,0,0,0,28,0,0
604815691,604815691,,0,0,0,0,0,0,0,0,0,0,61,0,0
1678694148,1678694148,,0,3,3,0,6,6,4,0.333333,0.37963,0,28,0,0
95073306,95073306,,1,0,1,2,0,2,0,0,0,0,28,0,0
1248216384577953792,1248216384577953792,,1,1,2,2,1,3,2,0.666667,0.75,0,28,0,0.020692
732817452569141248,732817452569141248,,1,1,2,2,1,3,3,0.449275,0.473118,0,28,0,0.000035
979013133229592576,979013133229592576,,0,0,0,0,0,0,0,0,0,0,62,0,0
15827039,15827039,,0,0,0,0,0,0,0,0,0,0,63,0,0
988115738157297664,988115738157297664,,0,0,0,0,0,0,0,0,0,0,64,0,0
1373748309538529280,1373748309538529280,,0,1,1,0,1,1,1,1,1,0,28,0,0.000001
2821329929,2821329929,,1,1,2,1,2,3,3,0.454545,0.5,0.000001,110,0,0
408555723,408555723,,1,0,1,1,0,1,0,0,0,0,28,0,0
998943681964068864,998943681964068864,,1,2,3,1,2,3,3,0.481481,0.538462,0.000001,28,0,0.00006
142692876,142692876,,1,0,1,1,0,1,0,0,0,0,28,0,0
2189230435,2189230435,,1,0,1,1,0,1,0,0,0,0,28,0,0
1142472685,1142472685,,0,0,0,0,0,0,0,0,0,0,65,0,0
1167745005785624576,1167745005785624576,,0,0,0,0,0,0,0,0,0,0,66,0,0
336770410,336770410,,0,1,1,0,1,1,1,1,1,0,28,0,0.000022
1392726045082767360,1392726045082767360,,4,0,4,10,0,10,0,0,0,0,21,0.001161,0
1431199650267156480,1431199650267156480,,1,0,1,2,0,2,0,0,0,0,21,0.001114,0
849274159,849274159,,4,2,6,7,4,11,2,0.625,0.7,0.000003,21,0.001117,0.000019
60836149,60836149,,1,4,5,1,4,5,9,0.209141,0.223349,0.000006,21,0.001114,0.022694
139765259,139765259,,1,1,2,1,1,2,2,0.666667,0.75,0,21,0.001114,0.000949
1087476792007495680,1087476792007495680,,2,12,14,2,14,16,9,0.278604,0.34404,0.000102,13,0.001125,0.055631
702614277472034816,702614277472034816,,2,3,5,2,3,5,9,0.185369,0.20136,0.000004,18,0.001125,0.001027
2732447529,2732447529,,4,0,4,4,0,4,0,0,0,0,21,0.001796,0
4171327882,4171327882,,2,3,5,2,3,5,8,0.303688,0.344033,0.000079,21,0.001125,0.005312
564577739,564577739,,0,2,2,0,2,2,1,1,1,0,37,0,0.000105
1239510410883194880,1239510410883194880,,1,0,1,1,0,1,0,0,0,0,37,0.000003,0
451314155,451314155,,15,0,15,15,0,15,0,0,0,0,37,0.00359,0
763146166620057600,763146166620057600,,0,5,5,0,5,5,2,0.666667,0.75,0,28,0,0.018048
1265196404,1265196404,,1,0,1,1,0,1,0,0,0,0,28,0.000527,0
422669338,422669338,,3,0,3,6,0,6,0,0,0,0,9,0.000597,0
1427635120761147392,1427635120761147392,,1,1,2,1,2,3,3,0.428571,0.5,0,9,0.000596,0.000062
423088643,423088643,,8,0,8,9,0,9,0,0,0,0,19,0.001292,0
1435000999,1435000999,,0,0,0,0,0,0,0,0,0,0,67,0,0
1227633852753104896,1227633852753104896,,0,2,2,0,2,2,6,0.392422,0.432414,0,13,0,0.004197
628527048,628527048,,6,4,10,6,6,12,1,1,1,0.000007,13,0.001628,0.000183
982680634492678144,982680634492678144,,0,1,1,0,1,1,2,0.666667,0.75,0,13,0,0.017924
1410927961918816256,1410927961918816256,,0,1,1,0,1,1,2,0.6,0.666667,0,28,0,0
831730153,831730153,,1,2,3,1,4,5,1,1,1,0,28,0,0.000001
1394326105658732544,1394326105658732544,,0,0,0,0,0,0,0,0,0,0,68,0,0
714601992400867328,714601992400867328,,0,0,0,0,0,0,0,0,0,0,69,0,0
795917638140624896,795917638140624896,,0,3,3,0,3,3,8,0.239964,0.255367,0,18,0,0.002119
741682596,741682596,,0,2,2,0,2,2,9,0.185025,0.198573,0,13,0,0.000265
1159893804465446912,1159893804465446912,,1,0,1,1,0,1,0,0,0,0,13,0,0
2997456399,2997456399,,1,0,1,1,0,1,0,0,0,0,13,0,0
1310565298920136704,1310565298920136704,,1,1,2,1,1,2,1,1,1,0,13,0,0.003445
1173366318671835136,1173366318671835136,,1,3,4,1,4,5,7,0.285015,0.306251,0.000009,13,0,0.043425
1854292736,1854292736,,1,0,1,1,0,1,0,0,0,0,13,0,0
415571726,415571726,,1,0,1,2,0,2,0,0,0,0,13,0.000004,0
1330089541458407424,1330089541458407424,,1,0,1,2,0,2,0,0,0,0,13,0.000004,0
728525736185896960,728525736185896960,,1,1,2,1,1,2,8,0.303216,0.342457,0.000002,13,0.000004,0.00479
3256484373,3256484373,,1,2,3,1,2,3,8,0.270403,0.29586,0.000003,13,0.000004,0.02007
287566348,287566348,,1,2,3,1,2,3,7,0.283757,0.302997,0,13,0.000004,0.022733
1132967503347539968,1132967503347539968,,1,0,1,1,0,1,0,0,0,0,13,0.000004,0
1375743073511149568,1375743073511149568,,1,1,2,1,1,2,2,0.666667,0.75,0,13,0.000004,0.017924
1393640480219484160,1393640480219484160,,1,2,3,1,2,3,2,0.666667,0.75,0,13,0.000004,0.038617
1445450650955890688,1445450650955890688,,1,3,4,1,3,4,7,0.278081,0.313688,0.000001,18,0.000004,0.002347
609509895,609509895,,1,2,3,1,3,4,6,0.39213,0.43218,0.000001,13,0.000004,0.004154
1414329936727494656,1414329936727494656,,1,0,1,1,0,1,0,0,0,0,13,0.000004,0
1445113546468122624,1445113546468122624,,1,1,2,1,1,2,2,0.666667,0.75,0,13,0.000004,0.020692
2359406918,2359406918,,1,0,1,1,0,1,0,0,0,0,13,0.000004,0
431764046,431764046,,1,0,1,1,0,1,0,0,0,0,13,0.000004,0
514440497,514440497,,1,1,2,1,1,2,2,0.666667,0.75,0,13,0.000004,0.000949
147283848,147283848,,1,0,1,1,0,1,0,0,0,0,13,0.000004,0
1017306026,1017306026,,1,0,1,1,0,1,0,0,0,0,13,0.000004,0
45391358,45391358,,1,0,1,1,0,1,0,0,0,0,13,0.000004,0
1438089144,1438089144,,1,0,1,1,0,1,0,0,0,0,13,0.000004,0
1050648530,1050648530,,1,1,2,1,1,2,2,0.666667,0.75,0,13,0.000004,0.020692
2535751839,2535751839,,3,3,6,3,3,6,6,0.293706,0.356746,0.000008,37,0.000618,0.003566
115558584,115558584,,1,1,2,1,1,2,2,0.666667,0.75,0,13,0.000004,0.017924
1157677543178276864,1157677543178276864,,1,0,1,1,0,1,0,0,0,0,13,0.000004,0
1348021263936196608,1348021263936196608,,2,1,3,2,1,3,1,1,1,0.00001,14,0.000214,0
1096333074,1096333074,,1,0,1,1,0,1,0,0,0,0,13,0.000004,0
1371863183523209216,1371863183523209216,,1,1,2,1,1,2,2,0.666667,0.75,0,13,0.000004,0.017924
412975315,412975315,,0,1,1,0,1,1,1,1,1,0,70,0,0
979129982445408256,979129982445408256,,1,0,1,1,0,1,0,0,0,0,70,0,0
1117579771,1117579771,,0,0,0,0,0,0,0,0,0,0,71,0,0
1311620060012851200,1311620060012851200,,0,1,1,0,1,1,8,0.228777,0.237669,0,9,0,0.000063
275754256,275754256,,2,1,3,2,1,3,8,0.223273,0.234582,0.000022,9,0.000652,0.000188
3073944291,3073944291,,1,0,1,1,0,1,0,0,0,0,9,0.000002,0
872477161545977856,872477161545977856,,1,1,2,1,1,2,8,0.303216,0.342457,0.000007,9,0.000002,0.00479
1415545030740168704,1415545030740168704,,1,3,4,1,3,4,7,0.330575,0.365418,0.000007,9,0.000002,0.030292
291605617,291605617,,1,0,1,1,0,1,0,0,0,0,9,0.000002,0
1099057975669477376,1099057975669477376,,1,1,2,1,1,2,7,0.283203,0.300698,0,9,0.000002,0.004809
1241681826349027328,1241681826349027328,,1,0,1,1,0,1,0,0,0,0,9,0.000002,0
342102454,342102454,,3,6,9,3,6,9,6,0.393996,0.434187,0.000181,5,0.000664,0.049935
1437410817557868544,1437410817557868544,,0,0,0,0,0,0,0,0,0,0,72,0,0
1357812068,1357812068,,0,0,0,0,0,0,0,0,0,0,73,0,0
400551850,400551850,,0,0,0,0,0,0,0,0,0,0,74,0,0
617210011,617210011,,0,0,0,0,0,0,0,0,0,0,75,0,0
752845778,752845778,,0,3,3,0,3,3,9,0.209351,0.22356,0,13,0,0.021481
924002019765116928,924002019765116928,,1,0,1,1,0,1,0,0,0,0,18,0.000001,0
1162393112762863616,1162393112762863616,,1,0,1,1,0,1,0,0,0,0,18,0.000001,0
1596356294,1596356294,,1,0,1,1,0,1,0,0,0,0,13,0.000001,0
1234044433496236032,1234044433496236032,,1,0,1,1,0,1,0,0,0,0,13,0.000001,0
1342568763410018304,1342568763410018304,,0,0,0,0,0,0,0,0,0,0,76,0,0
1113373655755644928,1113373655755644928,,0,0,0,0,0,0,0,0,0,0,77,0,0
974766065325608960,974766065325608960,,0,1,1,0,2,2,5,0.327731,0.349145,0,15,0,0
956636032002396160,956636032002396160,,1,3,4,2,3,5,4,0.475,0.510965,0.000001,15,0,0.001605
2480323358,2480323358,,0,2,2,0,2,2,6,0.392422,0.432414,0,13,0,0.004197
1374129418793279488,1374129418793279488,,0,1,1,0,1,1,2,0.555556,0.6,0,13,0,0.000048
283613414,283613414,,7,0,7,8,0,8,0,0,0,0,13,0.001739,0
1029331125410390016,1029331125410390016,,1,0,1,1,0,1,0,0,0,0,13,0.000005,0
1417408230624485376,1417408230624485376,,1,0,1,1,0,1,0,0,0,0,13,0.000005,0
26480258,26480258,,0,0,0,0,0,0,0,0,0,0,78,0,0
436107386,436107386,,0,0,0,0,0,0,0,0,0,0,79,0,0
1318248812155183104,1318248812155183104,,4,0,4,4,0,4,0,0,0,0,18,0.000678,0
1238143563017474048,1238143563017474048,,0,4,4,0,6,6,8,0.275275,0.306834,0,14,0,0.006079
469398862,469398862,,2,8,10,2,8,10,9,0.224795,0.247749,0.000066,13,0.000251,0.000048
510786998,510786998,,1,2,3,1,3,4,5,0.473939,0.486019,0.000058,28,0.000001,0.000081
1202181396883812352,1202181396883812352,,1,2,3,1,2,3,1,1,1,0,13,0.000001,0.002126
1401771027496067072,1401771027496067072,,1,0,1,1,0,1,0,0,0,0,13,0.000001,0
356159314,356159314,,1,0,1,1,0,1,0,0,0,0,13,0.000001,0
821147892,821147892,,1,0,1,1,0,1,0,0,0,0,13,0.000001,0
2373624002,2373624002,,1,0,1,1,0,1,0,0,0,0,13,0.000001,0
1254388401152933888,1254388401152933888,,0,2,2,0,2,2,8,0.303468,0.34324,0,9,0,0.004795
213990589,213990589,,1,0,1,1,0,1,0,0,0,0,9,0.00014,0
39028896,39028896,,0,1,1,0,1,1,1,1,1,0,28,0,0.000022
1447120818161455104,1447120818161455104,,1,6,7,2,12,14,2,0.75,0.833333,0.000001,110,0,0.000013
534504035,534504035,,0,1,1,0,1,1,1,1,1,0,28,0,0.000022
3129004528,3129004528,,0,2,2,0,2,2,9,0.208933,0.222329,0,18,0,0.004185
1370119848,1370119848,,0,0,0,0,0,0,0,0,0,0,80,0,0
1079226488,1079226488,,0,1,1,0,1,1,7,0.246678,0.259379,0,28,0,0.000001
1059728797610708992,1059728797610708992,,0,1,1,0,1,1,1,1,1,0,18,0,0.000038
1197158807140483072,1197158807140483072,,0,3,3,0,3,3,8,0.271004,0.297173,0,18,0,0.02104
994117492866998272,994117492866998272,,0,1,1,0,1,1,3,0.444444,0.541667,0,19,0,0.000002
558032072,558032072,,11,1,12,11,1,12,2,0.6,0.666667,0,19,0.000079,0.000056
3945715215,3945715215,,0,2,2,0,2,2,2,0.75,0.833333,0,206,0,0.017992
893067019,893067019,,0,1,1,0,1,1,7,0.246678,0.259379,0,28,0,0.000001
499757110,499757110,,2,0,2,2,0,2,0,0,0,0,15,0.000606,0
1169364879872057344,1169364879872057344,,1,0,1,1,0,1,0,0,0,0,15,0.00088,0
944017750388822016,944017750388822016,,1,1,2,1,2,3,1,1,1,0,25,0.00088,0.00062
721052101649002496,721052101649002496,,1,2,3,1,4,5,2,0.625,0.7,0.000003,9,0.00088,0.000017
471874775,471874775,,1,0,1,1,0,1,0,0,0,0,15,0.00088,0
4723561829,4723561829,,1,0,1,1,0,1,0,0,0,0,15,0.00088,0
1143677174,1143677174,,7,0,7,7,0,7,0,0,0,0,15,0.003776,0
2541790483,2541790483,,0,0,0,0,0,0,0,0,0,0,81,0,0
3139667865,3139667865,,0,2,2,0,3,3,5,0.450575,0.473129,0,28,0,0.000084
2523733551,2523733551,,0,2,2,0,2,2,9,0.183623,0.195518,0,18,0,0.001553
2150026569,2150026569,,0,4,4,0,6,6,7,0.286138,0.320032,0,13,0,0.023175
1641096138,1641096138,,0,1,1,0,1,1,1,1,1,0,28,0,0
2857162997,2857162997,,0,1,1,0,1,1,7,0.246678,0.259379,0,28,0,0.000001
174587095,174587095,,0,1,1,0,1,1,3,0.473684,0.518519,0,28,0,0
612113541,612113541,,0,0,0,0,0,0,0,0,0,0,82,0,0
1373688109565673472,1373688109565673472,,0,1,1,0,1,1,9,0.183116,0.192791,0,18,0,0.00097
610102005,610102005,,0,5,5,0,5,5,5,0.453287,0.477863,0,28,0,0.000067
1269003628666331136,1269003628666331136,,1,0,1,1,0,1,0,0,0,0,28,0.000002,0
1101021343,1101021343,,1,0,1,1,0,1,0,0,0,0,5,0.000747,0
1372227242638577664,1372227242638577664,,1,1,2,1,1,2,1,1,1,0,5,0.000747,0.001513
1015918388428918784,1015918388428918784,,1,4,5,1,4,5,7,0.285294,0.307969,0,5,0.000747,0.04687
1029428054324649984,1029428054324649984,,3,3,6,3,3,6,4,0.428571,0.534722,0.000013,250,0.002035,0.000073
497279830,497279830,,0,1,1,0,1,1,9,0.183116,0.192791,0,18,0,0.00097
3018077717,3018077717,,0,2,2,0,2,2,1,1,1,0,28,0,0
17581745,17581745,,2,0,2,2,0,2,0,0,0,0,28,0,0
4193423303,4193423303,,4,0,4,4,0,4,0,0,0,0,28,0,0
868487182524321792,868487182524321792,,1,0,1,1,0,1,0,0,0,0,28,0,0
1358809860251541504,1358809860251541504,,1,0,1,1,0,1,0,0,0,0,28,0,0
2945479804,2945479804,,1,0,1,1,0,1,0,0,0,0,28,0,0
1199125387000926208,1199125387000926208,,1,0,1,1,0,1,0,0,0,0,28,0,0
380526746,380526746,,1,0,1,1,0,1,0,0,0,0,28,0,0
898261931475316736,898261931475316736,,1,2,3,1,2,3,1,1,1,0,28,0,0.000001
729861715970658304,729861715970658304,,0,9,9,0,9,9,6,0.376953,0.420596,0,15,0,0.015361
1337250006,1337250006,,0,2,2,0,3,3,9,0.183686,0.195616,0,14,0,0.002483
1320978290841190400,1320978290841190400,,1,1,2,1,2,3,3,0.466667,0.52381,0.000002,18,0.000546,0.000001
998570888843972608,998570888843972608,,2,2,4,2,3,5,1,1,1,0.000003,110,0.000547,0.00002
479798072,479798072,,4,0,4,4,0,4,0,0,0,0,13,0.001576,0
193903859,193903859,,0,1,1,0,1,1,1,1,1,0,18,0,0.000583
1161744419038609408,1161744419038609408,,0,2,2,0,2,2,9,0.183623,0.195518,0,13,0,0.001001
255516922,255516922,,0,2,2,0,2,2,9,0.183623,0.195518,0,18,0,0.001553
195515224,195515224,,0,1,1,0,1,1,2,0.666667,0.75,0,13,0,0
1237045959789613056,1237045959789613056,,0,5,5,0,5,5,9,0.256707,0.31124,0,15,0,0.010659
512436792,512436792,,1,0,1,2,0,2,0,0,0,0,14,0.000699,0
984081495231954944,984081495231954944,,0,1,1,0,1,1,1,1,1,0,18,0,0.000044
14060262,14060262,,3,0,3,3,0,3,0,0,0,0,15,0.000151,0
1431948920712744960,1431948920712744960,,0,0,0,0,0,0,0,0,0,0,83,0,0
1419075771428184064,1419075771428184064,,0,0,0,0,0,0,0,0,0,0,84,0,0
584677870,584677870,,0,0,0,0,0,0,0,0,0,0,85,0,0
93369052,93369052,,2,0,2,2,0,2,0,0,0,0,18,0.00169,0
144213581,144213581,,0,0,0,0,0,0,0,0,0,0,86,0,0
955259736227803136,955259736227803136,,0,1,1,0,1,1,9,0.21953,0.235079,0,18,0,0.000486
1271498174570602496,1271498174570602496,,0,1,1,0,2,2,3,0.486486,0.509259,0,33,0,0
1728224730,1728224730,,0,4,4,0,6,6,5,0.43,0.46938,0,15,0,0.002251
1159859284357910528,1159859284357910528,,0,6,6,0,6,6,2,0.75,0.833333,0,15,0,0.006854
1431667972242817024,1431667972242817024,,1,2,3,1,4,5,1,1,1,0,15,0.0002,0
714417878,714417878,,1,0,1,2,0,2,0,0,0,0,21,0.000028,0
318316637,318316637,,4,4,8,9,8,17,2,0.75,0.833333,0.000016,18,0.000028,0
3380070149,3380070149,,0,1,1,0,1,1,1,1,1,0,18,0,0.000583
1414839320746340352,1414839320746340352,,0,1,1,0,1,1,5,0.449942,0.471782,0,28,0,0.000046
2476155712,2476155712,,0,1,1,0,1,1,1,1,1,0,18,0,0.000583
794390564,794390564,,0,1,1,0,1,1,9,0.183116,0.192791,0,18,0,0.00097
977286491897565184,977286491897565184,,2,0,2,2,0,2,0,0,0,0,13,0.000567,0
3352779975,3352779975,,2,3,5,2,3,5,2,0.714286,0.8,0.000021,21,0.000777,0.000182
2365685257,2365685257,,3,0,3,3,0,3,0,0,0,0,13,0.001106,0
2324434960,2324434960,,0,1,1,0,1,1,1,1,1,0,18,0,0.000583
1067802307,1067802307,,0,1,1,0,1,1,3,0.444444,0.541667,0,19,0,0.000002
451410343,451410343,,0,0,0,0,0,0,0,0,0,0,87,0,0
14909195,14909195,,4,0,4,4,0,4,0,0,0,0,13,0.003102,0
468641665,468641665,,0,1,1,0,1,1,9,0.183116,0.192791,0,18,0,0.00097
31395684,31395684,,0,1,1,0,1,1,1,1,1,0,88,0,0
306139229,306139229,,1,0,1,1,0,1,0,0,0,0,88,0,0
2755844146,2755844146,,0,0,0,0,0,0,0,0,0,0,89,0,0
1096096899604586496,1096096899604586496,,1,0,1,2,0,2,0,0,0,0,14,0.000978,0
2195968707,2195968707,,3,1,4,3,1,4,5,0.425926,0.455797,0.000009,9,0.001004,0.00159
246940612,246940612,,2,5,7,2,5,7,6,0.381771,0.425526,0.000057,14,0.001188,0.025183
885303356,885303356,,1,0,1,1,0,1,0,0,0,0,14,0.000978,0
930408417172312064,930408417172312064,,1,0,1,1,0,1,0,0,0,0,14,0.000978,0
92260294,92260294,,2,1,3,2,1,3,2,0.666667,0.75,0.000005,15,0.001629,0.000095
765979700808286208,765979700808286208,,2,0,2,2,0,2,0,0,0,0,14,0.00098,0
2173051843,2173051843,,1,0,1,1,0,1,0,0,0,0,14,0.000978,0
2405656973,2405656973,,1,1,2,1,1,2,2,0.666667,0.75,0,14,0.000978,0.020692
1290519342,1290519342,,1,0,1,1,0,1,0,0,0,0,14,0.000978,0
318316671,318316671,,0,0,0,0,0,0,0,0,0,0,90,0,0
1297082123044651008,1297082123044651008,,0,0,0,0,0,0,0,0,0,0,91,0,0
2814117855,2814117855,,0,1,1,0,1,1,9,0.21953,0.235079,0,18,0,0.000486
887300792654475264,887300792654475264,,0,4,4,0,5,5,7,0.249425,0.267484,0,28,0,0.000062
914866272,914866272,,1,6,7,2,12,14,1,1,1,0,28,0.000002,0
1053632622465818624,1053632622465818624,,0,4,4,0,5,5,7,0.285294,0.307969,0,13,0,0.02302
1422305016619151360,1422305016619151360,,0,3,3,0,3,3,7,0.273342,0.307908,0,18,0,0.020642
1000480351905632256,1000480351905632256,,0,5,5,0,10,10,12,0.164736,0.192368,0,19,0,0.000101
1276940590392004608,1276940590392004608,,1,0,1,2,0,2,0,0,0,0,19,0.000003,0
1294037310363795456,1294037310363795456,,5,0,5,5,0,5,0,0,0,0,19,0.000008,0
1435219709251702784,1435219709251702784,,0,2,2,0,2,2,7,0.272727,0.306162,0,14,0,0.022827
928688975824465920,928688975824465920,,0,1,1,0,1,1,2,0.666667,0.75,0,57,0,0
1432021980455309312,1432021980455309312,,0,3,3,0,3,3,5,0.452463,0.474937,0,57,0,0.000046
1375113163323146240,1375113163323146240,,9,2,11,9,2,11,2,0.75,0.833333,0,28,0.000002,0
522542520,522542520,,0,2,2,0,2,2,5,0.450575,0.473129,0,28,0,0.000046
298914032,298914032,,1,2,3,1,2,3,2,0.75,0.833333,0.000001,14,0.000029,0.01794
2871560767,2871560767,,0,1,1,0,1,1,1,1,1,0,13,0,0.000046
377003849,377003849,,0,0,0,0,0,0,0,0,0,0,92,0,0
412670404,412670404,,0,1,1,0,1,1,1,1,1,0,93,0,0
948427543,948427543,,1,0,1,1,0,1,0,0,0,0,93,0,0
1413475542041571328,1413475542041571328,,4,0,4,4,0,4,0,0,0,0,14,0.000001,0
1297975722733002752,1297975722733002752,,0,1,1,0,1,1,3,0.486486,0.509259,0,33,0,0
1415609071508627456,1415609071508627456,,0,1,1,0,1,1,1,1,1,0,15,0,0.000228
327455219,327455219,,1,0,1,1,0,1,0,0,0,0,18,0,0
2747514027,2747514027,,0,1,1,0,1,1,1,1,1,0,94,0,0
203003796,203003796,,2,0,2,2,0,2,0,0,0,0,94,0,0
1574749020,1574749020,,1,0,1,1,0,1,0,0,0,0,13,0.00083,0
4471273349,4471273349,,0,1,1,0,1,1,9,0.21953,0.235079,0,18,0,0.000486
1434078851739668480,1434078851739668480,,0,1,1,0,1,1,2,0.6,0.666667,0,13,0,0.000075
1050141832758341632,1050141832758341632,,0,2,2,0,3,3,1,1,1,0,94,0,0
447377103,447377103,,1,0,1,2,0,2,0,0,0,0,94,0,0
1451274686613053440,1451274686613053440,,0,0,0,0,0,0,0,0,0,0,95,0,0
1267572979497607168,1267572979497607168,,1,0,1,1,0,1,0,0,0,0,17,0,0
406932718,406932718,,1,0,1,1,0,1,0,0,0,0,14,0,0
730712433325703168,730712433325703168,,0,1,1,0,1,1,3,0.486486,0.509259,0,33,0,0
1265542837724221440,1265542837724221440,,0,3,3,0,3,3,2,0.636364,0.714286,0,13,0,0.038692
22252395,22252395,,0,0,0,0,0,0,0,0,0,0,96,0,0
1295388501748461568,1295388501748461568,,0,2,2,0,2,2,5,0.430303,0.464085,0,18,0,0.001605
1329025585717399552,1329025585717399552,,0,1,1,0,1,1,3,0.444444,0.5,0,18,0,0.000308
964595359610580992,964595359610580992,,0,1,1,0,1,1,1,1,1,0,18,0,0.000038
1442090815887532032,1442090815887532032,,0,1,1,0,1,1,9,0.183116,0.192791,0,18,0,0.00097
941772138008268800,941772138008268800,,0,5,5,0,6,6,9,0.188889,0.212627,0,15,0,0.02233
134858666,134858666,,0,1,1,0,1,1,8,0.239742,0.254313,0,250,0,0.000495
1256926144168853504,1256926144168853504,,0,3,3,0,3,3,2,0.636364,0.714286,0,14,0,0.000143
1302708024360996864,1302708024360996864,,1,0,1,1,0,1,0,0,0,0,14,0.000004,0
1422169571281285120,1422169571281285120,,0,1,1,0,1,1,1,1,1,0,57,0,0.000082
1013131070441746432,1013131070441746432,,0,1,1,0,1,1,2,0.571429,0.625,0,15,0,0.000054
1025041897,1025041897,,1,2,3,1,4,5,8,0.270403,0.29586,0.000011,13,0.000004,0.02007
880154586308333568,880154586308333568,,1,0,1,1,0,1,0,0,0,0,9,0.000004,0
84031812,84031812,,1,0,1,1,0,1,0,0,0,0,9,0.000004,0
1337835585034186752,1337835585034186752,,1,0,1,1,0,1,0,0,0,0,9,0.000004,0
1130521967864500224,1130521967864500224,,1,4,5,1,4,5,6,0.396,0.437654,0.000003,9,0.000004,0.01082
3288652618,3288652618,,2,2,4,2,2,4,6,0.391781,0.432051,0.000004,9,0.000026,0.024842
494172683,494172683,,1,1,2,1,1,2,7,0.283203,0.300698,0,9,0.000004,0.004809
749218542,749218542,,3,0,3,3,0,3,0,0,0,0,9,0.00025,0
467359617,467359617,,2,2,4,2,2,4,2,0.75,0.833333,0.000012,37,0.000015,0.003463
823311933692592128,823311933692592128,,1,0,1,1,0,1,0,0,0,0,9,0.000004,0
740712360,740712360,,1,0,1,1,0,1,0,0,0,0,9,0.000004,0
802097584332558336,802097584332558336,,1,0,1,1,0,1,0,0,0,0,9,0.000004,0
1284455050203598848,1284455050203598848,,2,2,4,2,3,5,8,0.246385,0.261932,0.000024,13,0.000015,0.018465
1396921468127170560,1396921468127170560,,1,1,2,1,1,2,1,1,1,0,9,0.000004,0.00005
3019759853,3019759853,,1,0,1,1,0,1,0,0,0,0,9,0.000004,0
1445118390700498944,1445118390700498944,,0,1,1,0,1,1,2,0.666667,0.75,0,5,0,0.020692
49592235,49592235,,0,1,1,0,1,1,3,0.486486,0.509259,0,33,0,0
1266404263120572416,1266404263120572416,,0,0,0,0,0,0,0,0,0,0,97,0,0
1245553374,1245553374,,0,1,1,0,1,1,2,0.571429,0.625,0,15,0,0.000054
1101084636,1101084636,,0,0,0,0,0,0,0,0,0,0,98,0,0
4513753401,4513753401,,0,2,2,0,2,2,2,0.75,0.833333,0,13,0,0.01797
86538176,86538176,,1,0,1,1,0,1,0,0,0,0,15,0.000298,0
392728431,392728431,,0,3,3,0,3,3,7,0.285997,0.319457,0,18,0,0.005251
400262316,400262316,,0,3,3,0,3,3,9,0.226201,0.246417,0,18,0,0.005365
845923825426583552,845923825426583552,,0,1,1,0,1,1,8,0.239742,0.254313,0,250,0,0.000495
1203887463074344960,1203887463074344960,,0,6,6,0,7,7,9,0.240553,0.282611,0,18,0,0.010465
4441303487,4441303487,,1,2,3,2,2,4,1,1,1,0,18,0.000306,0.000046
949244210401697792,949244210401697792,,0,1,1,0,1,1,3,0.486486,0.509259,0,33,0,0
1418302669752606720,1418302669752606720,,0,0,0,0,0,0,0,0,0,0,99,0,0
231452301,231452301,,2,3,5,4,6,10,1,1,1,0.00003,9,0.000001,0
1107938084883185664,1107938084883185664,,0,1,1,0,1,1,1,1,1,0,100,0,0
1244233108255318016,1244233108255318016,,1,0,1,1,0,1,0,0,0,0,100,0,0
370895961,370895961,,0,1,1,0,1,1,9,0.21953,0.235079,0,18,0,0.000486
2820333045,2820333045,,0,3,3,0,3,3,2,0.548387,0.588235,0,57,0,0.000005
1450432511230742528,1450432511230742528,,0,0,0,0,0,0,0,0,0,0,101,0,0
587898727,587898727,,1,0,1,1,0,1,0,0,0,0,18,0.000011,0
926073735806881792,926073735806881792,,1,0,1,1,0,1,0,0,0,0,18,0.000011,0
1329549977463508992,1329549977463508992,,1,1,2,1,1,2,2,0.666667,0.75,0,18,0.000011,0.017924
1316956338996580352,1316956338996580352,,1,0,1,1,0,1,0,0,0,0,18,0.000011,0
400902983,400902983,,1,2,3,1,3,4,8,0.239871,0.254935,0.000075,250,0.000011,0.021188
829089536613478400,829089536613478400,,1,1,2,2,1,3,9,0.208881,0.221934,0.000008,18,0.000011,0.000741
420675994,420675994,,1,2,3,1,2,3,1,1,1,0.000005,14,0.000011,0.000017
836523541,836523541,,1,2,3,1,2,3,8,0.303436,0.343252,0.000019,15,0.000011,0.006259
1430257103483064320,1430257103483064320,,1,0,1,1,0,1,0,0,0,0,18,0.000011,0
1124942637134426112,1124942637134426112,,1,1,2,1,1,2,2,0.666667,0.75,0,18,0.000011,0.020692
1557557558,1557557558,,1,13,14,1,16,17,7,0.296188,0.334221,0.000024,250,0.000011,0.027381
3331127301,3331127301,,1,1,2,1,1,2,2,0.666667,0.75,0,18,0.000011,0.020692
1423961840044883968,1423961840044883968,,1,0,1,1,0,1,0,0,0,0,18,0.000011,0
1132395524764704768,1132395524764704768,,1,0,1,1,0,1,0,0,0,0,18,0.000011,0
1425194624033902592,1425194624033902592,,1,1,2,1,1,2,6,0.390411,0.429474,0.000013,18,0.000011,0.00415
1421959645283995648,1421959645283995648,,1,0,1,1,0,1,0,0,0,0,18,0.000011,0
1010974634617995264,1010974634617995264,,1,2,3,1,2,3,8,0.242093,0.257214,0.000083,18,0.000011,0.001236
1442386306626031616,1442386306626031616,,1,0,1,1,0,1,0,0,0,0,18,0.000011,0
52679176,52679176,,1,3,4,1,3,4,8,0.263953,0.28367,0.000016,18,0.000011,0.00632
836428490,836428490,,1,0,1,1,0,1,0,0,0,0,18,0.000011,0
445742018,445742018,,1,3,4,1,3,4,8,0.27053,0.296438,0.000032,18,0.000011,0.026283
1438832311051694080,1438832311051694080,,1,0,1,1,0,1,0,0,0,0,18,0.000011,0
1013117294,1013117294,,1,2,3,1,2,3,1,1,1,0.000001,15,0.000011,0.001764
828673675394170880,828673675394170880,,1,0,1,1,0,1,0,0,0,0,18,0.000011,0
1337331444226666496,1337331444226666496,,1,0,1,1,0,1,0,0,0,0,18,0.000011,0
994148481773309952,994148481773309952,,1,5,6,1,5,6,8,0.250552,0.271467,0.000021,18,0.000011,0.006048
209725661,209725661,,1,1,2,1,1,2,2,0.666667,0.75,0,18,0.000011,0.020692
1197916593289859072,1197916593289859072,,1,0,1,1,0,1,0,0,0,0,18,0.000011,0
2401743697,2401743697,,1,4,5,1,4,5,8,0.266059,0.297819,0.000091,18,0.000011,0.004718
1112726270993936384,1112726270993936384,,1,0,1,1,0,1,0,0,0,0,18,0.000011,0
200610844,200610844,,1,0,1,1,0,1,0,0,0,0,18,0.000011,0
1261637922228441088,1261637922228441088,,1,0,1,1,0,1,0,0,0,0,18,0.000011,0
966734737,966734737,,1,0,1,1,0,1,0,0,0,0,18,0.000011,0
3397089436,3397089436,,2,3,5,2,3,5,7,0.274583,0.310103,0.000023,15,0.000662,0.02049
987068240,987068240,,1,0,1,1,0,1,0,0,0,0,18,0.000011,0
1163094886943547392,1163094886943547392,,1,0,1,1,0,1,0,0,0,0,18,0.000011,0
988333988,988333988,,1,0,1,1,0,1,0,0,0,0,18,0.000011,0
420511942,420511942,,1,1,2,1,1,2,7,0.272226,0.304285,0.000007,18,0.000011,0.002135
2227643435,2227643435,,1,0,1,1,0,1,0,0,0,0,18,0.000011,0
772938597137801216,772938597137801216,,1,2,3,1,2,3,7,0.284457,0.30396,0,18,0.000011,0.025501
1089489767010582528,1089489767010582528,,1,0,1,1,0,1,0,0,0,0,18,0.000011,0
432211151,432211151,,1,2,3,1,3,4,2,0.666667,0.75,0.000001,21,0.000011,0.00106
1451157497721536512,1451157497721536512,,1,0,1,1,0,1,0,0,0,0,18,0.000011,0
903207318501957632,903207318501957632,,2,3,5,2,3,5,6,0.361794,0.405264,0.000063,18,0.000662,0.029633
1129671980649799680,1129671980649799680,,1,0,1,1,0,1,0,0,0,0,18,0.000011,0
1401911906,1401911906,,2,3,5,2,3,5,7,0.330445,0.365219,0.000039,13,0.000662,0.010184
1407037777464672256,1407037777464672256,,1,3,4,1,3,4,5,0.414634,0.511765,0.000003,13,0.000011,0.018159
1043236921126871040,1043236921126871040,,1,0,1,1,0,1,0,0,0,0,18,0.000011,0
4704035485,4704035485,,1,3,4,1,3,4,3,0.6,0.722222,0.000004,9,0.000011,0.020743
2794337039,2794337039,,7,0,7,7,0,7,0,0,0,0,13,0.003441,0
1260211459721777152,1260211459721777152,,0,1,1,0,1,1,3,0.486486,0.509259,0,33,0,0
1444294526357680128,1444294526357680128,,0,0,0,0,0,0,0,0,0,0,102,0,0
50233016,50233016,,0,1,1,0,1,1,1,1,1,0,28,0,0.000003
2964561533,2964561533,,1,0,1,1,0,1,0,0,0,0,33,0,0
85670395,85670395,,1,0,1,1,0,1,0,0,0,0,33,0,0
1351259683030491136,1351259683030491136,,1,0,1,1,0,1,0,0,0,0,33,0,0
833382724845129728,833382724845129728,,1,0,1,1,0,1,0,0,0,0,33,0,0
76016736,76016736,,1,0,1,1,0,1,0,0,0,0,33,0,0
1167004816603828224,1167004816603828224,,1,0,1,1,0,1,0,0,0,0,33,0,0
856063725249466368,856063725249466368,,1,0,1,1,0,1,0,0,0,0,33,0,0
948608774,948608774,,1,0,1,2,0,2,0,0,0,0,33,0,0
1180909486954946560,1180909486954946560,,1,0,1,1,0,1,0,0,0,0,33,0,0
893479063,893479063,,1,0,1,1,0,1,0,0,0,0,33,0,0
306261783,306261783,,1,0,1,1,0,1,0,0,0,0,33,0,0
1235676026950291456,1235676026950291456,,1,0,1,1,0,1,0,0,0,0,33,0,0
1259684209,1259684209,,1,1,2,1,2,3,1,1,1,0,33,0,0
419870475,419870475,,1,0,1,1,0,1,0,0,0,0,33,0,0
1055481505,1055481505,,1,1,2,1,1,2,1,1,1,0,19,0,0
1337861522274521088,1337861522274521088,,0,1,1,0,1,1,1,1,1,0,18,0,0.000038
1536363924,1536363924,,0,1,1,0,1,1,1,1,1,0,28,0,0
2789358389,2789358389,,0,0,0,0,0,0,0,0,0,0,103,0,0
972413087788781568,972413087788781568,,1,0,1,1,0,1,0,0,0,0,9,0.000419,0
1438762590763724800,1438762590763724800,,1,0,1,1,0,1,0,0,0,0,15,0,0
396727106,396727106,,0,3,3,0,3,3,9,0.184472,0.19963,0,18,0,0.01891
1352150731944562688,1352150731944562688,,3,1,4,5,2,7,1,1,1,0,18,0.000553,0
3107417745,3107417745,,1,0,1,1,0,1,0,0,0,0,57,0,0
260295210,260295210,,3,1,4,3,1,4,1,1,1,0.000001,304,0.000807,0
1381261109752164352,1381261109752164352,,0,1,1,0,1,1,1,1,1,0,18,0,0.000583
1025397335298334720,1025397335298334720,,0,5,5,0,5,5,9,0.201361,0.234973,0,18,0,0.044033
891742922198065152,891742922198065152,,1,2,3,1,2,3,2,0.75,0.833333,0,25,0.000525,0.022161
1041989831981780992,1041989831981780992,,0,3,3,0,3,3,9,0.184539,0.199741,0,18,0,0.039587
1150054581906432000,1150054581906432000,,1,2,3,1,3,4,9,0.208985,0.222478,0.000025,13,0.001386,0.018665
1016280316699398144,1016280316699398144,,3,2,5,3,3,6,1,1,1,0.000003,110,0.000713,0.000028
259642779,259642779,,0,1,1,0,1,1,1,1,1,0,104,0,0
805030253341065216,805030253341065216,,2,0,2,2,0,2,0,0,0,0,104,0,0
1433292218010382336,1433292218010382336,,1,0,1,2,0,2,0,0,0,0,110,0.000143,0
983289622817107968,983289622817107968,,5,0,5,16,0,16,0,0,0,0,110,0.000947,0
1442459086138740736,1442459086138740736,,2,0,2,2,0,2,0,0,0,0,110,0.000164,0
70971449,70971449,,1,1,2,4,2,6,1,1,1,0.000002,206,0,0
1600245451,1600245451,,0,2,2,0,3,3,8,0.270877,0.296597,0,13,0,0.003116
1161191406,1161191406,,0,3,3,0,3,3,4,0.485294,0.522727,0,9,0,0.001228
1416494687779753984,1416494687779753984,,6,0,6,6,0,6,0,0,0,0,9,0.00392,0
845643381141360640,845643381141360640,,0,3,3,0,3,3,2,0.548387,0.588235,0,57,0,0.000101
2182502256,2182502256,,2,1,3,2,1,3,1,1,1,0,57,0.000527,0
1373546804122370048,1373546804122370048,,0,1,1,0,1,1,1,1,1,0,28,0,0.000001
417094530,417094530,,0,0,0,0,0,0,0,0,0,0,105,0,0
36817494,36817494,,2,0,2,4,0,4,0,0,0,0,110,0.000694,0
1249385941250293760,1249385941250293760,,0,2,2,0,2,2,2,0.75,0.833333,0,15,0,0.000237
1246088563529302016,1246088563529302016,,0,6,6,0,7,7,6,0.363008,0.407758,0,13,0,0.032296
59440277,59440277,,0,0,0,0,0,0,0,0,0,0,106,0,0
285771597,285771597,,0,2,2,0,2,2,1,1,1,0,57,0,0.000082
225087522,225087522,,8,0,8,8,0,8,0,0,0,0,57,0.000002,0
1433045588149481472,1433045588149481472,,0,1,1,0,1,1,9,0.208881,0.221934,0,18,0,0.000741
958859016700071936,958859016700071936,,3,1,4,3,1,4,2,0.666667,0.75,0,13,0.002241,0.017924
1106253932777623552,1106253932777623552,,4,0,4,4,0,4,0,0,0,0,9,0.001703,0
241857339,241857339,,0,3,3,0,4,4,7,0.248112,0.263711,0,28,0,0.000021
4098849867,4098849867,,0,5,5,0,5,5,10,0.209825,0.237529,0,15,0,0.022295
1095408091,1095408091,,0,4,4,0,4,4,7,0.247967,0.26457,0,28,0,0.000023
452981919,452981919,,0,0,0,0,0,0,0,0,0,0,107,0,0
509356418,509356418,,0,0,0,0,0,0,0,0,0,0,108,0,0
108094277,108094277,,0,2,2,0,2,2,6,0.31141,0.321713,0,28,0,0
2416044272,2416044272,,1,0,1,1,0,1,0,0,0,0,28,0,0
1058916510,1058916510,,1,1,2,1,1,2,5,0.449942,0.471782,0.000006,28,0,0.000046
3023928790,3023928790,,1,0,1,2,0,2,0,0,0,0,9,0.000121,0
4570933648,4570933648,,0,1,1,0,1,1,1,1,1,0,9,0,0.000115
365861580,365861580,,0,0,0,0,0,0,0,0,0,0,109,0,0
64643056,64643056,,1,0,1,2,0,2,0,0,0,0,110,0.000036,0
87818409,87818409,,1,0,1,2,0,2,0,0,0,0,110,0.000036,0
5893702,5893702,,4,1,5,12,2,14,1,1,1,0.000006,110,0.000839,0
14159148,14159148,,1,0,1,2,0,2,0,0,0,0,110,0.000036,0
41370439,41370439,,1,0,1,2,0,2,0,0,0,0,110,0.000036,0
264169218,264169218,,1,0,1,4,0,4,0,0,0,0,110,0.000036,0
59474665,59474665,,1,0,1,4,0,4,0,0,0,0,110,0.000036,0
2097191,2097191,,1,0,1,2,0,2,0,0,0,0,110,0.000036,0
19016842,19016842,,1,0,1,2,0,2,0,0,0,0,110,0.000036,0
1113920359,1113920359,,1,0,1,2,0,2,0,0,0,0,110,0.000036,0
333366997,333366997,,1,0,1,2,0,2,0,0,0,0,110,0.000036,0
333354104,333354104,,1,0,1,2,0,2,0,0,0,0,110,0.000036,0
1113932371,1113932371,,1,0,1,6,0,6,0,0,0,0,110,0.000036,0
21397917,21397917,,1,0,1,2,0,2,0,0,0,0,110,0.000036,0
2501296444,2501296444,,1,0,1,2,0,2,0,0,0,0,110,0.000036,0
1262570369187221504,1262570369187221504,,1,0,1,2,0,2,0,0,0,0,110,0.000036,0
24744541,24744541,,1,0,1,4,0,4,0,0,0,0,110,0.000036,0
21882251,21882251,,1,0,1,2,0,2,0,0,0,0,110,0.000036,0
14436030,14436030,,1,0,1,2,0,2,0,0,0,0,110,0.000036,0
7996082,7996082,,1,0,1,2,0,2,0,0,0,0,110,0.000036,0
121385551,121385551,,1,0,1,2,0,2,0,0,0,0,110,0.000036,0
742143,742143,,2,0,2,4,0,4,0,0,0,0,110,0.000036,0
4119914644,4119914644,,1,0,1,2,0,2,0,0,0,0,110,0.000036,0
2467791,2467791,,1,0,1,2,0,2,0,0,0,0,110,0.000036,0
3108351,3108351,,1,0,1,2,0,2,0,0,0,0,110,0.000036,0
759251,759251,,1,0,1,2,0,2,0,0,0,0,110,0.000036,0
14293310,14293310,,1,0,1,2,0,2,0,0,0,0,110,0.000036,0
51241574,51241574,,1,0,1,2,0,2,0,0,0,0,110,0.000036,0
1652541,1652541,,1,0,1,2,0,2,0,0,0,0,110,0.000036,0
999578121123848192,999578121123848192,,2,0,2,4,0,4,0,0,0,0,110,0.000036,0
37706685,37706685,,1,0,1,2,0,2,0,0,0,0,110,0.000036,0
15892162,15892162,,1,0,1,2,0,2,0,0,0,0,110,0.000036,0
57763444,57763444,,1,0,1,2,0,2,0,0,0,0,110,0.000036,0
119844526,119844526,,1,0,1,2,0,2,0,0,0,0,110,0.000036,0
1445278328152334336,1445278328152334336,,1,0,1,1,0,1,0,0,0,0,110,0.000036,0
1018144154445144064,1018144154445144064,,1,0,1,1,0,1,0,0,0,0,110,0.000036,0
1180959747626983424,1180959747626983424,,1,0,1,1,0,1,0,0,0,0,110,0.000036,0
515778628,515778628,,1,0,1,1,0,1,0,0,0,0,110,0.000036,0
257517267,257517267,,1,0,1,1,0,1,0,0,0,0,110,0.000036,0
270763009,270763009,,1,0,1,1,0,1,0,0,0,0,110,0.000036,0
428460689,428460689,,1,1,2,1,1,2,2,0.666667,0.75,0,110,0.000036,0.017924
3298421851,3298421851,,1,0,1,1,0,1,0,0,0,0,110,0.000036,0
1214270543660142592,1214270543660142592,,1,0,1,1,0,1,0,0,0,0,110,0.000036,0
789553715766300672,789553715766300672,,1,0,1,1,0,1,0,0,0,0,110,0.000036,0
1262834658250838016,1262834658250838016,,1,1,2,1,1,2,1,1,1,0.000001,14,0.000036,0.000023
1326894779918147584,1326894779918147584,,1,0,1,1,0,1,0,0,0,0,110,0.000036,0
1369005530,1369005530,,1,0,1,1,0,1,0,0,0,0,110,0.000036,0
1217478537520861184,1217478537520861184,,2,3,5,2,5,7,2,0.714286,0.8,0.000006,13,0.000686,0.03865
629076877,629076877,,4,0,4,5,0,5,0,0,0,0,110,0.000905,0
1236255995984297984,1236255995984297984,,1,2,3,1,3,4,2,0.666667,0.75,0,13,0.000036,0.038617
222949759,222949759,,1,0,1,1,0,1,0,0,0,0,110,0.000036,0
1003613418669166592,1003613418669166592,,1,0,1,1,0,1,0,0,0,0,110,0.000036,0
4076497583,4076497583,,1,0,1,1,0,1,0,0,0,0,110,0.000036,0
1396729003382292480,1396729003382292480,,1,1,2,1,2,3,2,0.666667,0.75,0,13,0.000036,0.017924
1077644550,1077644550,,3,4,7,3,5,8,7,0.273567,0.309352,0.000054,13,0.000257,0.044196
1283915827,1283915827,,1,0,1,1,0,1,0,0,0,0,110,0.000036,0
582265897,582265897,,1,0,1,1,0,1,0,0,0,0,110,0.000036,0
1443622282392391680,1443622282392391680,,1,0,1,1,0,1,0,0,0,0,110,0.000036,0
390624729,390624729,,1,0,1,1,0,1,0,0,0,0,110,0.000036,0
457693768,457693768,,2,0,2,2,0,2,0,0,0,0,9,0.000246,0
1313836039614672896,1313836039614672896,,2,2,4,2,2,4,2,0.666667,0.75,0,9,0.000246,0.038617
600987661,600987661,,1,0,1,1,0,1,0,0,0,0,110,0.000036,0
1133089602410094592,1133089602410094592,,1,0,1,1,0,1,0,0,0,0,110,0.000036,0
2949050433,2949050433,,1,0,1,1,0,1,0,0,0,0,110,0.000036,0
833352342791716864,833352342791716864,,1,0,1,1,0,1,0,0,0,0,110,0.000036,0
916393981705043968,916393981705043968,,1,0,1,1,0,1,0,0,0,0,110,0.000036,0
1432327291967782912,1432327291967782912,,3,4,7,3,4,7,7,0.29922,0.324546,0.000044,25,0.000257,0.023411
1388156262970445824,1388156262970445824,,1,0,1,1,0,1,0,0,0,0,110,0.000036,0
354810008,354810008,,1,1,2,1,1,2,1,1,1,0,37,0.000036,0.003445
550782928,550782928,,2,1,3,2,1,3,2,0.666667,0.75,0,9,0.000246,0.017924
1395421356821463040,1395421356821463040,,1,0,1,1,0,1,0,0,0,0,110,0.000036,0
2472447136,2472447136,,2,0,2,2,0,2,0,0,0,0,9,0.000246,0
1440952481903779840,1440952481903779840,,1,1,2,1,1,2,8,0.303216,0.342457,0.000011,9,0.000036,0.00479
964053254819729408,964053254819729408,,2,3,5,2,3,5,7,0.285294,0.306537,0.000001,14,0.000246,0.027015
366160680,366160680,,1,2,3,1,2,3,2,0.75,0.833333,0,15,0.000036,0.022161
1323957701341306880,1323957701341306880,,1,0,1,1,0,1,0,0,0,0,110,0.000036,0
1438496986483683328,1438496986483683328,,1,4,5,1,4,5,6,0.394483,0.436597,0.000006,14,0.000036,0.022222
1108429576303271936,1108429576303271936,,1,1,2,1,1,2,7,0.283203,0.300698,0,9,0.000036,0.004809
363158162,363158162,,1,4,5,1,4,5,6,0.393151,0.435772,0.000007,15,0.000036,0.00788
487914485,487914485,,2,1,3,2,1,3,2,0.666667,0.75,0,110,0.000136,0.017924
2949096639,2949096639,,1,1,2,1,1,2,2,0.666667,0.75,0,110,0.000036,0.020692
519378175,519378175,,1,0,1,1,0,1,0,0,0,0,110,0.000036,0
792358290,792358290,,1,0,1,1,0,1,0,0,0,0,110,0.000036,0
1432603786212777984,1432603786212777984,,1,1,2,2,1,3,2,0.666667,0.75,0,110,0.000036,0.020692
1330254691683414016,1330254691683414016,,1,0,1,1,0,1,0,0,0,0,110,0.000036,0
4265017450,4265017450,,1,0,1,1,0,1,0,0,0,0,110,0.000036,0
477156618,477156618,,2,1,3,2,1,3,2,0.666667,0.75,0,9,0.000246,0.020692
311694861,311694861,,1,0,1,1,0,1,0,0,0,0,110,0.000036,0
1042763174,1042763174,,1,2,3,1,2,3,6,0.391484,0.431813,0.000005,9,0.000036,0.022074
1428363829482639360,1428363829482639360,,1,2,3,1,2,3,2,0.75,0.833333,0,15,0.000036,0.018204
1428207959692226560,1428207959692226560,,1,0,1,1,0,1,0,0,0,0,110,0.000036,0
1289547863979102208,1289547863979102208,,1,3,4,1,3,4,6,0.392857,0.434382,0.000005,9,0.000036,0.042767
139049202,139049202,,1,0,1,1,0,1,0,0,0,0,110,0.000036,0
168732280,168732280,,1,0,1,1,0,1,0,0,0,0,110,0.000036,0
1901585569,1901585569,,2,1,3,2,1,3,2,0.666667,0.75,0,9,0.000246,0.017924
986338892,986338892,,3,7,10,3,9,12,7,0.330579,0.377075,0.000062,13,0.000696,0.04806
435328721,435328721,,1,0,1,1,0,1,0,0,0,0,110,0.000036,0
1344470080487305216,1344470080487305216,,1,4,5,1,4,5,8,0.247142,0.264253,0.000015,18,0.000036,0.025648
1015245939467014144,1015245939467014144,,1,0,1,1,0,1,0,0,0,0,110,0.000036,0
2207984680,2207984680,,2,2,4,2,2,4,2,0.75,0.833333,0,9,0.000057,0.021635
751180558936530944,751180558936530944,,1,2,3,1,2,3,2,0.75,0.833333,0,15,0.000036,0.018074
1192343650887520256,1192343650887520256,,1,0,1,1,0,1,0,0,0,0,110,0.000036,0
29416653,29416653,,2,3,5,3,6,9,1,1,1,0.000004,250,0.000036,0.000046
965282676059115520,965282676059115520,,1,0,1,1,0,1,0,0,0,0,110,0.000036,0
413916151,413916151,,1,1,2,2,2,4,1,1,1,0.000003,250,0.0008,0
65872738,65872738,,1,0,1,2,0,2,0,0,0,0,250,0.0008,0
475091975,475091975,,2,0,2,4,0,4,0,0,0,0,250,0.000801,0
1355619217,1355619217,,1,1,2,1,1,2,2,0.666667,0.75,0,250,0.0008,0.000949
1304915840161263616,1304915840161263616,,1,1,2,1,1,2,2,0.6,0.666667,0.000002,110,0.0008,0.000021
1261809647738138624,1261809647738138624,,5,0,5,6,0,6,0,0,0,0,250,0.001566,0
106724705,106724705,,0,2,2,0,2,2,8,0.30361,0.343426,0,15,0,0.004932
1557863928,1557863928,,1,0,1,1,0,1,0,0,0,0,15,0,0
1439513438343008256,1439513438343008256,,0,2,2,0,2,2,7,0.247986,0.262772,0,250,0,0.000001
2322424306,2322424306,,3,3,6,3,3,6,1,1,1,0,250,0.000002,0
3818086949,3818086949,,1,0,1,1,0,1,0,0,0,0,28,0,0
537092257,537092257,,1,0,1,1,0,1,0,0,0,0,28,0,0
399580048,399580048,,1,0,1,1,0,1,0,0,0,0,28,0,0
490602212,490602212,,1,5,6,1,6,7,5,0.452982,0.477553,0.000035,28,0,0.000076
1222000628,1222000628,,1,0,1,1,0,1,0,0,0,0,28,0,0
1220792838,1220792838,,1,0,1,1,0,1,0,0,0,0,28,0,0
1205217770171965440,1205217770171965440,,1,0,1,1,0,1,0,0,0,0,28,0,0
389402849,389402849,,1,1,2,1,1,2,1,1,1,0,28,0,0.000001
826094250261626880,826094250261626880,,1,1,2,1,1,2,1,1,1,0,28,0,0.00006
971444556502831104,971444556502831104,,1,1,2,1,1,2,1,1,1,0,28,0,0.000001
431697186,431697186,,1,0,1,1,0,1,0,0,0,0,28,0,0
3632667623,3632667623,,1,0,1,1,0,1,0,0,0,0,28,0,0
1004874680,1004874680,,1,1,2,1,1,2,5,0.449942,0.471782,0.000034,28,0,0.000046
2263440430,2263440430,,1,1,2,1,1,2,1,1,1,0,28,0,0
606438986,606438986,,1,0,1,1,0,1,0,0,0,0,28,0,0
988846494,988846494,,1,0,1,1,0,1,0,0,0,0,28,0,0
966592213,966592213,,1,1,2,1,1,2,1,1,1,0,28,0,0
18680083,18680083,,1,0,1,1,0,1,0,0,0,0,28,0,0
322528854,322528854,,1,0,1,1,0,1,0,0,0,0,28,0,0
2828308970,2828308970,,1,0,1,1,0,1,0,0,0,0,28,0,0
66095201,66095201,,0,1,1,0,1,1,1,1,1,0,18,0,0.000583
1354112340237705216,1354112340237705216,,0,1,1,0,1,1,1,1,1,0,28,0,0.000001
1094639057198559232,1094639057198559232,,0,1,1,0,1,1,1,1,1,0,28,0,0
578950964,578950964,,0,1,1,0,1,1,9,0.183116,0.192791,0,18,0,0.00097
2886860662,2886860662,,0,1,1,0,1,1,8,0.239742,0.254313,0,250,0,0.000495
1241659242404352000,1241659242404352000,,10,2,12,12,2,14,1,1,1,0.000011,19,0.001918,0
786276460080209920,786276460080209920,,21,0,21,21,0,21,0,0,0,0,19,0.000002,0
1264302927340015616,1264302927340015616,,1,0,1,1,0,1,0,0,0,0,19,0.000002,0
187952542,187952542,,0,1,1,0,1,1,9,0.183116,0.192791,0,18,0,0.00097
401534305,401534305,,0,3,3,0,4,4,9,0.184145,0.198723,0,13,0,0.01976
4876948905,4876948905,,0,2,2,0,4,4,8,0.239828,0.254811,0,250,0,0.000498
1296055260394532864,1296055260394532864,,7,0,7,7,0,7,0,0,0,0,250,0.000092,0
730116701589753856,730116701589753856,,1,2,3,1,2,3,5,0.436709,0.469082,0.000001,15,0.000605,0.019514
1375740452385742848,1375740452385742848,,0,2,2,0,2,2,8,0.304035,0.343983,0,18,0,0.00576
876340085171642368,876340085171642368,,0,1,1,0,1,1,1,1,1,0,18,0,0.000583
917438823738626048,917438823738626048,,0,4,4,0,6,6,8,0.241881,0.258849,0,250,0,0.000733
1380125660,1380125660,,0,3,3,0,3,3,1,1,1,0,57,0,0.000004
22617135,22617135,,0,2,2,0,2,2,9,0.237551,0.277265,0,18,0,0.005531
1493548724,1493548724,,0,1,1,0,1,1,1,1,1,0,18,0,0.000583
1403405000865468416,1403405000865468416,,0,2,2,0,2,2,8,0.239914,0.25491,0,15,0,0.000775
240626745,240626745,,0,4,4,0,4,4,9,0.240778,0.279313,0,14,0,0.00443
1419201509389185024,1419201509389185024,,0,1,1,0,1,1,1,1,1,0,18,0,0.000583
1164079969,1164079969,,0,2,2,0,2,2,8,0.265582,0.296467,0,9,0,0.004645
1136537422836244480,1136537422836244480,,3,1,4,3,1,4,2,0.666667,0.75,0,15,0.000653,0.017924
1456739846,1456739846,,3,0,3,3,0,3,0,0,0,0,250,0.002226,0
754193799493083136,754193799493083136,,1,0,1,1,0,1,0,0,0,0,250,0.000546,0
478831382,478831382,,1,0,1,1,0,1,0,0,0,0,250,0.000546,0
1447664304388456448,1447664304388456448,,1,0,1,1,0,1,0,0,0,0,250,0.000546,0
4021839591,4021839591,,3,0,3,3,0,3,0,0,0,0,21,0.000776,0
1284740064816365568,1284740064816365568,,0,1,1,0,1,1,9,0.183116,0.192791,0,18,0,0.00097
1272523678140555264,1272523678140555264,,0,3,3,0,3,3,9,0.184587,0.199349,0,9,0,0.001044
952124790,952124790,,2,1,3,3,1,4,1,1,1,0,110,0.000832,0.003445
799219281451958272,799219281451958272,,0,2,2,0,3,3,8,0.286387,0.321669,0,250,0,0.005286
1378201201192398848,1378201201192398848,,0,1,1,0,1,1,1,1,1,0,14,0,0.00007
1424103954430971904,1424103954430971904,,0,1,1,0,1,1,8,0.239742,0.254313,0,250,0,0.000495
1173223843,1173223843,,0,2,2,0,2,2,3,0.454545,0.511111,0,19,0,0.000098
1262242734,1262242734,,5,0,5,5,0,5,0,0,0,0,28,0.000004,0
14401794,14401794,,1,0,1,1,0,1,0,0,0,0,28,0.000002,0
23920614,23920614,,0,1,1,0,1,1,9,0.208881,0.221934,0,18,0,0.000741
915673854143582208,915673854143582208,,0,2,2,0,2,2,6,0.391245,0.431469,0,18,0,0.004733
2910727479,2910727479,,0,1,1,0,1,1,9,0.183116,0.192791,0,18,0,0.00097
89425310,89425310,,0,1,1,0,1,1,1,1,1,0,18,0,0.000038
1149939188210573312,1149939188210573312,,2,0,2,3,0,3,0,0,0,0,13,0.000055,0
975016903,975016903,,0,1,1,0,1,1,1,1,1,0,28,0,0
483782123,483782123,,0,1,1,0,1,1,1,1,1,0,57,0,0.000082
1356002909436207104,1356002909436207104,,0,3,3,0,3,3,12,0.164577,0.191435,0,19,0,0.000101
3368018859,3368018859,,0,7,7,0,8,8,6,0.397878,0.443,0,14,0,0.035047
1059984817,1059984817,,2,2,4,3,2,5,3,0.538462,0.619048,0.000026,14,0.001125,0
790164996667871232,790164996667871232,,0,2,2,0,2,2,9,0.18408,0.196644,0,18,0,0.021662
1445084370256252928,1445084370256252928,,0,1,1,0,1,1,8,0.239742,0.254313,0,250,0,0.000495
1154265726,1154265726,,0,2,2,0,3,3,2,0.6,0.666667,0,14,0,0.000085
1443994474301038592,1443994474301038592,,0,3,3,0,3,3,6,0.362076,0.40543,0,18,0,0.00991
830018012753313792,830018012753313792,,0,4,4,0,4,4,8,0.250345,0.270769,0,18,0,0.023205
1206934325171761152,1206934325171761152,,0,2,2,0,2,2,3,0.5,0.633333,0,19,0,0.000002
2867547191,2867547191,,0,1,1,0,1,1,1,1,1,0,18,0,0.000583
589997252,589997252,,1,0,1,1,0,1,0,0,0,0,18,0.000488,0
1254136538990104576,1254136538990104576,,0,2,2,0,2,2,9,0.183572,0.195899,0,18,0,0.018894
119418146,119418146,,0,2,2,0,3,3,8,0.223565,0.237725,0,18,0,0.000971
588434195,588434195,,1,1,2,2,1,3,7,0.283203,0.300698,0.000005,18,0.000028,0.004809
912816336,912816336,,0,1,1,0,1,1,9,0.183116,0.192791,0,18,0,0.00097
423531049,423531049,,1,0,1,4,0,4,0,0,0,0,19,0.000022,0
1351192180019359744,1351192180019359744,,1,0,1,2,0,2,0,0,0,0,19,0.000022,0
3087139251,3087139251,,1,0,1,1,0,1,0,0,0,0,19,0.000022,0
1375132658,1375132658,,1,0,1,1,0,1,0,0,0,0,19,0.000022,0
2740676513,2740676513,,1,0,1,1,0,1,0,0,0,0,19,0.000022,0
623687670,623687670,,1,1,2,1,1,2,2,0.6,0.666667,0.000004,206,0.000022,0.000004
1233777638742908928,1233777638742908928,,1,0,1,1,0,1,0,0,0,0,19,0.000022,0
1327026353607204864,1327026353607204864,,1,1,2,1,1,2,1,1,1,0,19,0.000022,0
1446825229020540928,1446825229020540928,,1,2,3,1,3,4,3,0.481481,0.538462,0,19,0.000022,0.020788
1447215498,1447215498,,2,1,3,2,1,3,2,0.666667,0.75,0,14,0.000033,0.020692
1257066184203272192,1257066184203272192,,2,2,4,2,3,5,6,0.391484,0.431813,0.000033,13,0.000232,0.022074
1203087605849608192,1203087605849608192,,1,0,1,1,0,1,0,0,0,0,19,0.000022,0
428588499,428588499,,1,1,2,1,1,2,1,1,1,0,19,0.000022,0.000038
126727689,126727689,,3,1,4,3,1,4,1,1,1,0.000001,13,0.000684,0.000584
944473056,944473056,,0,2,2,0,2,2,8,0.304035,0.343983,0,18,0,0.00576
1393541650471919616,1393541650471919616,,0,3,3,0,3,3,7,0.285573,0.318831,0,18,0,0.004864
721338072097558528,721338072097558528,,0,0,0,0,0,0,0,0,0,0,111,0,0
46701371,46701371,,1,0,1,1,0,1,0,0,0,0,14,0.00068,0
932342300365197312,932342300365197312,,0,1,1,0,1,1,4,0.37037,0.433333,0,110,0,0.00001
792793865489117184,792793865489117184,,0,8,8,0,10,10,6,0.364613,0.409445,0,13,0,0.055688
704969816176775168,704969816176775168,,0,2,2,0,2,2,8,0.303468,0.34324,0,18,0,0.005374
1447464780034461696,1447464780034461696,,0,2,2,0,2,2,9,0.190389,0.205575,0,25,0,0.000978
436124417,436124417,,0,4,4,0,4,4,8,0.305011,0.346315,0,18,0,0.023729
828717014,828717014,,2,0,2,4,0,4,0,0,0,0,110,0.000219,0
1024976264,1024976264,,3,0,3,5,0,5,0,0,0,0,110,0.000219,0
1258838192779923456,1258838192779923456,,1,0,1,1,0,1,0,0,0,0,110,0.000219,0
1080786410980950016,1080786410980950016,,1,2,3,1,2,3,3,0.571429,0.708333,0.000001,110,0.000219,0.003449
836645258716905472,836645258716905472,,2,0,2,2,0,2,0,0,0,0,110,0.000263,0
714167586,714167586,,0,1,1,0,1,1,1,1,1,0,18,0,0.000583
1435636771505811456,1435636771505811456,,0,2,2,0,2,2,6,0.391245,0.431469,0,18,0,0.004733
1422169613333323776,1422169613333323776,,0,2,2,0,2,2,7,0.283902,0.303101,0,18,0,0.005392
234493045,234493045,,0,1,1,0,1,1,9,0.208881,0.221934,0,18,0,0.000741
1300884946878427136,1300884946878427136,,0,5,5,0,5,5,7,0.287237,0.314162,0,18,0,0.026432
52996515,52996515,,0,1,1,0,1,1,9,0.183116,0.192791,0,18,0,0.00097
492136342,492136342,,0,1,1,0,1,1,9,0.183116,0.192791,0,18,0,0.00097
1321477886151450624,1321477886151450624,,0,2,2,0,2,2,8,0.216151,0.234649,0,13,0,0.000234
413114256,413114256,,0,6,6,0,6,6,9,0.238223,0.279556,0,33,0,0.008664
1417369836288684032,1417369836288684032,,0,2,2,0,2,2,7,0.273171,0.306404,0,19,0,0.002137
1066574400,1066574400,,0,1,1,0,1,1,9,0.208881,0.221934,0,18,0,0.000741
1374300920,1374300920,,0,1,1,0,1,1,1,1,1,0,28,0,0
2236900491,2236900491,,3,4,7,3,4,7,2,0.833333,0.9,0.000003,15,0.000041,0.020594
2871320398,2871320398,,1,0,1,1,0,1,0,0,0,0,9,0.000022,0
1044907412,1044907412,,1,0,1,1,0,1,0,0,0,0,9,0.000022,0
373950389,373950389,,1,4,5,1,4,5,3,0.55,0.651515,0,14,0.000022,0.022523
1337831564785422336,1337831564785422336,,1,0,1,1,0,1,0,0,0,0,9,0.000022,0
423474251,423474251,,1,0,1,1,0,1,0,0,0,0,9,0.000022,0
1039960589857157120,1039960589857157120,,1,0,1,1,0,1,0,0,0,0,9,0.000022,0
48001776,48001776,,1,1,2,1,1,2,2,0.666667,0.75,0,9,0.000022,0.020692
1371468588796805120,1371468588796805120,,2,1,3,2,1,3,2,0.666667,0.75,0,9,0.000552,0.000949
1168229197984215040,1168229197984215040,,1,2,3,1,3,4,6,0.391484,0.431813,0.000001,13,0.000022,0.022074
1259041459,1259041459,,2,1,3,2,1,3,2,0.666667,0.75,0.000001,9,0.00003,0.000949
1435715007744983040,1435715007744983040,,2,0,2,2,0,2,0,0,0,0,13,0.000122,0
1354788769912786944,1354788769912786944,,1,0,1,1,0,1,0,0,0,0,9,0.000022,0
1319345300578967552,1319345300578967552,,1,2,3,1,2,3,2,0.75,0.833333,0,15,0.000022,0.020972
301461154,301461154,,1,1,2,1,1,2,1,1,1,0,5,0.000022,0.000237
1037692622,1037692622,,1,1,2,1,1,2,1,1,1,0,13,0.000022,0.000051
501113059,501113059,,2,1,3,2,2,4,1,1,1,0,15,0.000158,0.00029
1443233239158644736,1443233239158644736,,2,1,3,2,1,3,1,1,1,0,206,0.000131,0.000024
726046220,726046220,,1,0,1,2,0,2,0,0,0,0,18,0.000022,0
2959021829,2959021829,,2,0,2,2,0,2,0,0,0,0,15,0.000611,0
1050358452,1050358452,,0,0,0,0,0,0,0,0,0,0,112,0,0
1155857190483300352,1155857190483300352,,0,1,1,0,1,1,9,0.208881,0.221934,0,18,0,0.000741
1431651335867338752,1431651335867338752,,0,4,4,0,5,5,8,0.31989,0.363188,0,13,0,0.025831
2867024507,2867024507,,0,1,1,0,1,1,1,1,1,0,57,0,0.000082
100337538,100337538,,0,0,0,0,0,0,0,0,0,0,113,0,0
972147007279321088,972147007279321088,,0,1,1,0,1,1,9,0.208881,0.221934,0,18,0,0.000741
88151199,88151199,,1,0,1,1,0,1,0,0,0,0,9,0,0
1386021180549779456,1386021180549779456,,0,0,0,0,0,0,0,0,0,0,114,0,0
533006458,533006458,,0,1,1,0,1,1,1,1,1,0,14,0,0.00007
2657539389,2657539389,,0,1,1,0,1,1,1,1,1,0,28,0,0.000001
981832592,981832592,,0,1,1,0,1,1,9,0.208881,0.221934,0,18,0,0.000741
1047780978104700928,1047780978104700928,,0,1,1,0,1,1,9,0.208881,0.221934,0,18,0,0.000741
2986274967,2986274967,,0,1,1,0,1,1,1,1,1,0,104,0,0
3521214922,3521214922,,1,0,1,1,0,1,0,0,0,0,15,0,0
1398897288098033664,1398897288098033664,,1,0,1,1,0,1,0,0,0,0,15,0,0
823588089322995712,823588089322995712,,1,0,1,1,0,1,0,0,0,0,15,0,0
2432146794,2432146794,,0,1,1,0,1,1,1,1,1,0,57,0,0.000082
434705268,434705268,,0,1,1,0,1,1,1,1,1,0,14,0,0.00007
1049651106790473728,1049651106790473728,,0,1,1,0,1,1,1,1,1,0,28,0,0.00006
418767604,418767604,,0,3,3,0,3,3,9,0.184194,0.198334,0,18,0,0.004418
1266404090935992320,1266404090935992320,,1,0,1,1,0,1,0,0,0,0,18,0.000129,0
2374304095,2374304095,,0,3,3,0,3,3,9,0.209167,0.223101,0,18,0,0.02153
1409126362934304768,1409126362934304768,,0,0,0,0,0,0,0,0,0,0,115,0,0
1292048738458972160,1292048738458972160,,0,3,3,0,3,3,7,0.286267,0.308116,0,9,0,0.006391
1971394236,1971394236,,0,1,1,0,1,1,9,0.183116,0.192791,0,18,0,0.00097
1239586047274729472,1239586047274729472,,0,1,1,0,1,1,9,0.208881,0.221934,0,18,0,0.000741
1017112352158863360,1017112352158863360,,1,0,1,1,0,1,0,0,0,0,19,0.000009,0
2288557992,2288557992,,1,2,3,1,2,3,6,0.391781,0.432051,0.000004,19,0.000009,0.024842
1291835087311511552,1291835087311511552,,1,0,1,1,0,1,0,0,0,0,19,0.000009,0
410910327,410910327,,1,0,1,1,0,1,0,0,0,0,19,0.000009,0
1417400258594758656,1417400258594758656,,2,0,2,2,0,2,0,0,0,0,19,0.000219,0
1009362391258288128,1009362391258288128,,2,1,3,2,1,3,2,0.666667,0.75,0,19,0.00066,0.020692
98457187,98457187,,1,1,2,1,1,2,2,0.666667,0.75,0,19,0.000009,0.017924
489909029,489909029,,1,0,1,1,0,1,0,0,0,0,19,0.000009,0
432948366,432948366,,1,0,1,1,0,1,0,0,0,0,19,0.000009,0
1337162385006751744,1337162385006751744,,1,0,1,1,0,1,0,0,0,0,19,0.000009,0
209249028,209249028,,2,2,4,2,2,4,2,0.75,0.833333,0.000014,15,0.000219,0.000715
254969508,254969508,,1,0,1,1,0,1,0,0,0,0,19,0.000009,0
1214739008,1214739008,,2,0,2,2,0,2,0,0,0,0,19,0.000013,0
2595566549,2595566549,,1,0,1,1,0,1,0,0,0,0,19,0.000009,0
1058619467968774144,1058619467968774144,,2,5,7,3,6,9,7,0.286982,0.311577,0.000007,13,0.00066,0.02446
972612694338662400,972612694338662400,,1,1,2,1,1,2,1,1,1,0,15,0.000009,0.001469
1459440192,1459440192,,1,0,1,1,0,1,0,0,0,0,19,0.000009,0
304290908,304290908,,1,1,2,1,1,2,7,0.283203,0.300698,0,19,0.000009,0.004809
4734101189,4734101189,,1,0,1,1,0,1,0,0,0,0,19,0.000009,0
82083043,82083043,,1,1,2,1,1,2,2,0.666667,0.75,0,19,0.000009,0.020692
253531074,253531074,,1,0,1,1,0,1,0,0,0,0,19,0.000009,0
738350242597310464,738350242597310464,,1,2,3,1,2,3,2,0.75,0.833333,0,13,0.000009,0.021277
373049625,373049625,,1,1,2,1,1,2,6,0.390411,0.429474,0.000004,19,0.000009,0.00415
1241515700423995392,1241515700423995392,,1,0,1,1,0,1,0,0,0,0,19,0.000009,0
124426856,124426856,,1,0,1,1,0,1,0,0,0,0,19,0.000009,0
96960470,96960470,,1,2,3,1,2,3,2,0.666667,0.75,0.000004,206,0.000009,0.000241
2320478792,2320478792,,1,1,2,1,1,2,9,0.208881,0.221934,0.000164,18,0.000009,0.000741
849213722,849213722,,1,2,3,1,2,3,7,0.284457,0.30396,0,19,0.000009,0.025501
1423614587153305600,1423614587153305600,,0,3,3,0,3,3,9,0.189772,0.212414,0,9,0,0.019164
1277103846,1277103846,,0,1,1,0,1,1,1,1,1,0,28,0,0
1247413935227224064,1247413935227224064,,0,1,1,0,1,1,2,0.666667,0.75,0,5,0,0.020692
1060030321,1060030321,,0,0,0,0,0,0,0,0,0,0,116,0,0
943585471657054208,943585471657054208,,0,0,0,0,0,0,0,0,0,0,117,0,0
531490926,531490926,,0,4,4,0,4,4,2,0.833333,0.9,0,57,0,0.021954
3325347729,3325347729,,0,2,2,0,2,2,1,1,1,0,57,0,0.000117
1401952436760330240,1401952436760330240,,0,0,0,0,0,0,0,0,0,0,118,0,0
1238409776637399040,1238409776637399040,,0,0,0,0,0,0,0,0,0,0,119,0,0
1240547335182135296,1240547335182135296,,0,1,1,0,1,1,9,0.208881,0.221934,0,18,0,0.000741
1384380813819715584,1384380813819715584,,0,0,0,0,0,0,0,0,0,0,120,0,0
1451182798472056832,1451182798472056832,,0,0,0,0,0,0,0,0,0,0,121,0,0
1085863038,1085863038,,0,7,7,0,7,7,9,0.239721,0.277713,0,57,0,0.022452
2679606969,2679606969,,0,1,1,0,1,1,9,0.208881,0.221934,0,18,0,0.000741
4207484511,4207484511,,0,2,2,0,2,2,3,0.5,0.537037,0,17,0,0
113398061,113398061,,3,14,17,3,14,17,2,0.888889,0.9375,0.000001,17,0,0
469111179,469111179,,0,1,1,0,1,1,1,1,1,0,14,0,0.00007
774502888387252224,774502888387252224,,0,0,0,0,0,0,0,0,0,0,122,0,0
1415639456611250176,1415639456611250176,,0,2,2,0,3,3,1,1,1,0,14,0,0.00007
565495704,565495704,,2,0,2,3,0,3,0,0,0,0,14,0.00001,0
890642578726637568,890642578726637568,,0,1,1,0,1,1,1,1,1,0,28,0,0
480635666,480635666,,0,0,0,0,0,0,0,0,0,0,123,0,0
1385164772,1385164772,,0,0,0,0,0,0,0,0,0,0,124,0,0
1020744549889642496,1020744549889642496,,0,2,2,0,2,2,7,0.272672,0.305848,0,14,0,0.002204
234436737,234436737,,0,1,1,0,1,1,1,1,1,0,15,0,0.000228
887013587780329472,887013587780329472,,0,2,2,0,2,2,7,0.283902,0.303101,0,14,0,0.004878
1439856575376760832,1439856575376760832,,0,3,3,0,3,3,2,0.714286,0.8,0,57,0,0.038699
1451119733709934592,1451119733709934592,,0,0,0,0,0,0,0,0,0,0,125,0,0
707825100867969024,707825100867969024,,0,1,1,0,1,1,1,1,1,0,17,0,0
568418849,568418849,,0,3,3,0,4,4,6,0.389182,0.431525,0,13,0,0.023044
2787225059,2787225059,,0,0,0,0,0,0,0,0,0,0,126,0,0
163969416,163969416,,0,3,3,0,4,4,9,0.209057,0.22289,0,15,0,0.021475
1317270325659422720,1317270325659422720,,0,1,1,0,1,1,9,0.208881,0.221934,0,18,0,0.000741
4866306605,4866306605,,0,1,1,0,1,1,1,1,1,0,127,0,0
1308809627262488576,1308809627262488576,,1,0,1,1,0,1,0,0,0,0,127,0,0
1449713480441946112,1449713480441946112,,0,1,1,0,1,1,9,0.208881,0.221934,0,18,0,0.000741
1394329195468165120,1394329195468165120,,0,3,3,0,3,3,9,0.209063,0.222973,0,18,0,0.039357
1321087382997913600,1321087382997913600,,1,0,1,2,0,2,0,0,0,0,110,0.000525,0
796050937194356736,796050937194356736,,0,1,1,0,1,1,1,1,1,0,17,0,0
3359722569,3359722569,,1,2,3,1,2,3,8,0.239878,0.254869,0.000036,28,0,0.000497
2393110796,2393110796,,1,1,2,1,1,2,1,1,1,0,28,0,0.000001
961184737,961184737,,1,0,1,1,0,1,0,0,0,0,28,0,0
124113240,124113240,,4,0,4,4,0,4,0,0,0,0,14,0.000579,0
1247343212,1247343212,,2,0,2,2,0,2,0,0,0,0,14,0,0
755323758991306752,755323758991306752,,0,0,0,0,0,0,0,0,0,0,128,0,0
455966686,455966686,,0,0,0,0,0,0,0,0,0,0,129,0,0
1092873760900894720,1092873760900894720,,0,3,3,0,3,3,7,0.330582,0.365342,0,18,0,0.009614
383487053,383487053,,0,1,1,0,1,1,1,1,1,0,28,0,0
3423529899,3423529899,,0,2,2,0,2,2,1,1,1,0,28,0,0.000082
2525069528,2525069528,,0,1,1,0,1,1,2,0.666667,0.75,0,28,0,0
3217391668,3217391668,,0,1,1,0,1,1,9,0.208881,0.221934,0,18,0,0.000741
2377487094,2377487094,,2,0,2,3,0,3,0,0,0,0,13,0.00113,0
1444968822184857600,1444968822184857600,,0,5,5,0,5,5,9,0.245517,0.289002,0,25,0,0.028884
1121435322863292416,1121435322863292416,,0,1,1,0,1,1,9,0.208881,0.221934,0,18,0,0.000741
922977180,922977180,,0,2,2,0,2,2,3,0.571429,0.708333,0,15,0,0.00029
1240786200,1240786200,,1,1,2,1,1,2,2,0.666667,0.75,0,15,0.000008,0.020692
138736601,138736601,,0,1,1,0,2,2,2,0.666667,0.75,0,130,0,0
514552306,514552306,,1,1,2,2,2,4,1,1,1,0,130,0,0
497816379,497816379,,2,0,2,2,0,2,0,0,0,0,18,0.000061,0
1410870161985388544,1410870161985388544,,0,3,3,0,5,5,8,0.253505,0.277535,0,250,0,0.002633
1446188469076770816,1446188469076770816,,0,1,1,0,1,1,1,1,1,0,28,0,0
83580262,83580262,,0,0,0,0,0,0,0,0,0,0,131,0,0
489703663,489703663,,1,0,1,2,0,2,0,0,0,0,18,0.000021,0
198073780,198073780,,1,2,3,2,3,5,1,1,1,0.000008,18,0.000021,0.000001
1370732523135893504,1370732523135893504,,1,6,7,2,7,9,6,0.365916,0.409945,0.000236,15,0.000021,0.015124
1222227577,1222227577,,1,1,2,1,2,3,4,0.421053,0.489583,0.000005,15,0.000021,0.000431
3023197061,3023197061,,1,0,1,1,0,1,0,0,0,0,18,0.000021,0
1425349002862682112,1425349002862682112,,1,0,1,1,0,1,0,0,0,0,18,0.000021,0
1099567670,1099567670,,1,0,1,1,0,1,0,0,0,0,18,0.000021,0
1424317867634434048,1424317867634434048,,1,0,1,1,0,1,0,0,0,0,18,0.000021,0
1701198374,1701198374,,1,4,5,1,5,6,7,0.330709,0.365975,0.000062,13,0.000021,0.02767
353921615,353921615,,1,0,1,1,0,1,0,0,0,0,18,0.000021,0
81196561,81196561,,1,0,1,1,0,1,0,0,0,0,18,0.000021,0
323952207,323952207,,1,2,3,1,2,3,6,0.379812,0.421021,0.000059,18,0.000021,0.006285
271489389,271489389,,1,1,2,1,1,2,6,0.390411,0.429474,0.000032,18,0.000021,0.00415
2197175103,2197175103,,1,0,1,1,0,1,0,0,0,0,18,0.000021,0
2895641883,2895641883,,1,4,5,1,4,5,7,0.330839,0.366173,0.000061,13,0.000021,0.030438
566258291,566258291,,1,1,2,1,1,2,8,0.239742,0.254313,0.000367,18,0.000021,0.000495
1254348607060353024,1254348607060353024,,1,1,2,1,1,2,2,0.666667,0.75,0,18,0.000021,0.020692
3929435800,3929435800,,1,0,1,1,0,1,0,0,0,0,18,0.000021,0
937676699935920128,937676699935920128,,1,0,1,1,0,1,0,0,0,0,18,0.000021,0
122976053,122976053,,1,1,2,1,1,2,7,0.272226,0.304285,0.000027,18,0.000021,0.002135
4634857036,4634857036,,1,1,2,1,1,2,1,1,1,0.000002,18,0.000021,0.000018
328022080,328022080,,1,2,3,1,2,3,1,1,1,0,18,0.000021,0.024137
1334153931207929856,1334153931207929856,,0,2,2,0,2,2,3,0.457143,0.489583,0,28,0,0.000037
983708472851292160,983708472851292160,,0,0,0,0,0,0,0,0,0,0,132,0,0
1420143127919276032,1420143127919276032,,0,1,1,0,1,1,1,1,1,0,133,0,0
1370063970,1370063970,,5,0,5,5,0,5,0,0,0,0,133,0,0
294535863,294535863,,0,3,3,0,6,6,8,0.240014,0.255426,0,250,0,0.000496
1382422174011699200,1382422174011699200,,1,0,1,2,0,2,0,0,0,0,250,0.000014,0
1423697829453783040,1423697829453783040,,1,0,1,2,0,2,0,0,0,0,250,0.000014,0
332133904,332133904,,4,2,6,4,3,7,1,1,1,0.000005,18,0.001806,0.000037
2559437932,2559437932,,0,1,1,0,1,1,2,0.666667,0.75,0,21,0,0.00007
783626379074138112,783626379074138112,,0,2,2,0,2,2,8,0.239871,0.254935,0,250,0,0.021188
1173863861033865216,1173863861033865216,,0,0,0,0,0,0,0,0,0,0,134,0,0
1443518245596708864,1443518245596708864,,1,0,1,2,0,2,0,0,0,0,18,0.000203,0
1255129783958007808,1255129783958007808,,0,1,1,0,2,2,8,0.239742,0.254313,0,250,0,0.000495
351445191,351445191,,1,3,4,2,5,7,7,0.294229,0.318389,0.000037,25,0.000651,0.005199
766462243,766462243,,1,1,2,2,1,3,2,0.666667,0.75,0,13,0.000651,0.017924
402580562,402580562,,1,10,11,3,28,31,6,0.410628,0.455686,0.000056,110,0.000651,0.027433
585558104,585558104,,1,0,1,1,0,1,0,0,0,0,13,0.000651,0
718825104,718825104,,1,1,2,1,1,2,7,0.283203,0.300698,0,9,0.000651,0.004809
988373714,988373714,,1,2,3,1,2,3,4,0.476923,0.508065,0.000007,21,0.000651,0.001868
1252304048440647680,1252304048440647680,,1,0,1,1,0,1,0,0,0,0,13,0.000651,0
614105197,614105197,,1,0,1,1,0,1,0,0,0,0,13,0.000651,0
1445508753684451328,1445508753684451328,,1,2,3,1,2,3,6,0.391484,0.431813,0.000011,9,0.000651,0.022074
140142801,140142801,,1,0,1,1,0,1,0,0,0,0,13,0.000651,0
851112127,851112127,,1,0,1,1,0,1,0,0,0,0,13,0.000651,0
6012422,6012422,,2,0,2,2,0,2,0,0,0,0,14,0.000662,0
2377143224,2377143224,,1,3,4,2,4,6,2,0.8,0.875,0.000001,13,0.000651,0.019452
1145470195,1145470195,,1,0,1,1,0,1,0,0,0,0,13,0.000651,0
910676940,910676940,,1,0,1,1,0,1,0,0,0,0,13,0.000651,0
1364225080859926528,1364225080859926528,,1,4,5,2,4,6,7,0.287893,0.312039,0.000015,13,0.000651,0.006431
772520766885728256,772520766885728256,,1,5,6,1,5,6,7,0.290578,0.334872,0.00007,14,0.000651,0.005057
1081038630,1081038630,,1,2,3,1,2,3,3,0.5,0.537037,0.00001,9,0.000651,0.018195
990881832,990881832,,1,1,2,1,2,3,2,0.666667,0.75,0,13,0.000651,0.017924
1344805435153543168,1344805435153543168,,1,1,2,1,1,2,1,1,1,0,9,0.000651,0.000943
1170404625301852160,1170404625301852160,,1,0,1,1,0,1,0,0,0,0,13,0.000651,0
2709419717,2709419717,,1,0,1,1,0,1,0,0,0,0,13,0.000651,0
2515461941,2515461941,,1,0,1,1,0,1,0,0,0,0,13,0.000651,0
1427632842075475968,1427632842075475968,,1,2,3,1,2,3,8,0.303546,0.34345,0.000019,13,0.000651,0.025483
1851884437,1851884437,,2,4,6,2,4,6,3,0.525424,0.55914,0.000009,14,0.000662,0.043063
188888607,188888607,,1,1,2,1,1,2,8,0.303216,0.342457,0.000019,9,0.000651,0.00479
420415403,420415403,,1,0,1,1,0,1,0,0,0,0,13,0.000651,0
1449468040245035008,1449468040245035008,,1,2,3,1,2,3,8,0.303546,0.34345,0.000019,13,0.000651,0.025483
1065446190,1065446190,,1,2,3,1,2,3,2,0.75,0.833333,0.000002,18,0.000651,0.020783
956175940891136000,956175940891136000,,1,0,1,1,0,1,0,0,0,0,13,0.000651,0
1426490692474392576,1426490692474392576,,1,1,2,1,1,2,2,0.666667,0.75,0,13,0.000651,0.017924
4362453375,4362453375,,1,2,3,1,2,3,7,0.293069,0.335328,0.000022,14,0.000651,0.003725
1910488188,1910488188,,1,0,1,1,0,1,0,0,0,0,13,0.000651,0
944382516,944382516,,1,1,2,1,1,2,1,1,1,0.000002,18,0.000651,0.000092
1283518398,1283518398,,1,2,3,2,2,4,7,0.305755,0.334223,0.000011,13,0.000651,0.006399
1036329954798129152,1036329954798129152,,2,5,7,2,5,7,6,0.423581,0.459851,0.000055,14,0.000662,0.048577
2938255667,2938255667,,1,1,2,1,1,2,1,1,1,0,37,0.000651,0.003445
1401927860512825344,1401927860512825344,,1,0,1,1,0,1,0,0,0,0,13,0.000651,0
475150043,475150043,,1,1,2,1,2,3,2,0.666667,0.75,0,13,0.000651,0.017924
1302188269908656128,1302188269908656128,,1,1,2,1,1,2,2,0.666667,0.75,0,13,0.000651,0.020692
1429064793697226752,1429064793697226752,,1,0,1,1,0,1,0,0,0,0,13,0.000651,0
222176911,222176911,,1,0,1,1,0,1,0,0,0,0,13,0.000651,0
1116790574,1116790574,,1,0,1,1,0,1,0,0,0,0,13,0.000651,0
38903873,38903873,,1,0,1,2,0,2,0,0,0,0,13,0.000651,0
1357828860394536960,1357828860394536960,,1,0,1,1,0,1,0,0,0,0,13,0.000651,0
499876766,499876766,,1,0,1,1,0,1,0,0,0,0,13,0.000651,0
707353020640710656,707353020640710656,,1,1,2,1,1,2,2,0.666667,0.75,0,13,0.000651,0.020692
1242984717928083456,1242984717928083456,,1,0,1,1,0,1,0,0,0,0,13,0.000651,0
507570761,507570761,,1,3,4,1,3,4,6,0.392562,0.434152,0.000012,9,0.000651,0.005971
434123289,434123289,,1,0,1,1,0,1,0,0,0,0,13,0.000651,0
4893362397,4893362397,,1,4,5,1,4,5,2,0.75,0.833333,0.000001,9,0.000651,0.041028
1121931434,1121931434,,1,1,2,1,1,2,6,0.390411,0.429474,0.000011,9,0.000651,0.00415
1249704716898091008,1249704716898091008,,1,0,1,1,0,1,0,0,0,0,13,0.000651,0
449615009,449615009,,1,0,1,1,0,1,0,0,0,0,13,0.000651,0
425659307,425659307,,1,1,2,1,1,2,6,0.390411,0.429474,0.000011,9,0.000651,0.00415
368118881,368118881,,1,2,3,1,2,3,1,1,1,0,37,0.000651,0.024137
1285866977693700096,1285866977693700096,,1,3,4,1,3,4,6,0.293706,0.356746,0.000011,15,0.000651,0.022244
1434615229686628352,1434615229686628352,,2,0,2,2,0,2,0,0,0,0,13,0.000861,0
1199397167493996544,1199397167493996544,,1,2,3,1,2,3,1,1,1,0,37,0.000651,0.024137
493680177,493680177,,1,0,1,1,0,1,0,0,0,0,13,0.000651,0
459589014,459589014,,1,0,1,1,0,1,0,0,0,0,13,0.000651,0
4611000693,4611000693,,1,1,2,1,1,2,1,1,1,0,15,0.000651,0.001469
131565005,131565005,,1,0,1,1,0,1,0,0,0,0,13,0.000651,0
1299087773601861632,1299087773601861632,,1,0,1,1,0,1,0,0,0,0,13,0.000651,0
104637433,104637433,,1,0,1,1,0,1,0,0,0,0,13,0.000651,0
3159816119,3159816119,,1,0,1,1,0,1,0,0,0,0,13,0.000651,0
1231573077722632192,1231573077722632192,,1,0,1,1,0,1,0,0,0,0,13,0.000651,0
1242481949437919232,1242481949437919232,,1,0,1,1,0,1,0,0,0,0,13,0.000651,0
96624832,96624832,,1,0,1,1,0,1,0,0,0,0,13,0.000651,0
1313951568891387904,1313951568891387904,,1,3,4,1,3,4,6,0.392562,0.434152,0.000011,37,0.000651,0.025519
426181894,426181894,,1,1,2,1,1,2,7,0.283203,0.300698,0,9,0.000651,0.004809
232559332,232559332,,1,0,1,1,0,1,0,0,0,0,13,0.000651,0
4747949368,4747949368,,1,1,2,2,1,3,2,0.666667,0.75,0.000001,13,0.000651,0.000949
1283167465,1283167465,,1,0,1,1,0,1,0,0,0,0,13,0.000651,0
566150054,566150054,,2,3,5,3,3,6,2,0.714286,0.8,0.00001,13,0.000861,0.038665
3928901475,3928901475,,1,3,4,1,3,4,5,0.443038,0.479048,0.000011,15,0.000651,0.040207
254242037,254242037,,1,0,1,1,0,1,0,0,0,0,13,0.000651,0
1159769104003321856,1159769104003321856,,1,0,1,1,0,1,0,0,0,0,13,0.000651,0
1442246890125287424,1442246890125287424,,1,0,1,1,0,1,0,0,0,0,13,0.000651,0
408756549,408756549,,1,0,1,1,0,1,0,0,0,0,13,0.000651,0
2846453086,2846453086,,1,0,1,1,0,1,0,0,0,0,13,0.000651,0
1011674388,1011674388,,1,2,3,1,2,3,7,0.330185,0.364425,0.000019,9,0.000651,0.009599
1259103016663289856,1259103016663289856,,1,3,4,1,3,4,2,0.8,0.875,0.000005,9,0.000651,0.018915
407685967,407685967,,1,1,2,1,2,3,1,1,1,0.000006,13,0.000651,0
87448728,87448728,,1,1,2,1,1,2,1,1,1,0,37,0.000651,0.003445
336406661,336406661,,1,1,2,1,1,2,2,0.52381,0.545455,0.000059,18,0.000651,0.000066
1032227404029280256,1032227404029280256,,1,0,1,1,0,1,0,0,0,0,13,0.000651,0
235712668,235712668,,1,2,3,1,2,3,2,0.666667,0.75,0,13,0.000651,0.038617
802233746648952832,802233746648952832,,1,0,1,1,0,1,0,0,0,0,13,0.000651,0
33574643,33574643,,1,4,5,1,4,5,6,0.422849,0.458421,0.000018,21,0.000651,0.023942
1089979686,1089979686,,1,1,2,1,1,2,1,1,1,0.000003,13,0.000651,0.000003
12266712,12266712,,2,1,3,2,1,3,2,0.666667,0.75,0,13,0.000861,0.020692
2173072229,2173072229,,1,0,1,1,0,1,0,0,0,0,13,0.000651,0
1272910866787323904,1272910866787323904,,1,0,1,1,0,1,0,0,0,0,13,0.000651,0
1632805556,1632805556,,1,0,1,1,0,1,0,0,0,0,13,0.000651,0
2682159590,2682159590,,2,0,2,2,0,2,0,0,0,0,14,0.000662,0
398240072,398240072,,1,0,1,1,0,1,0,0,0,0,13,0.000651,0
526532007,526532007,,1,0,1,1,0,1,0,0,0,0,13,0.000651,0
233531154,233531154,,1,1,2,1,1,2,2,0.666667,0.75,0,13,0.000651,0.017924
1471856263,1471856263,,1,0,1,1,0,1,0,0,0,0,13,0.000651,0
468441125,468441125,,2,4,6,2,5,7,7,0.307136,0.338634,0.00003,13,0.000861,0.025272
1220743790,1220743790,,1,0,1,1,0,1,0,0,0,0,13,0.000651,0
1437135834457821184,1437135834457821184,,1,1,2,1,1,2,1,1,1,0,37,0.000651,0.003445
40363134,40363134,,1,1,2,1,1,2,2,0.666667,0.75,0,13,0.000651,0.017924
332934650,332934650,,1,0,1,1,0,1,0,0,0,0,13,0.000651,0
1071485604,1071485604,,1,0,1,1,0,1,0,0,0,0,13,0.000651,0
1212034646,1212034646,,1,1,2,1,1,2,6,0.390411,0.429474,0.000011,9,0.000651,0.00415
366490597,366490597,,1,0,1,1,0,1,0,0,0,0,13,0.000651,0
995021599,995021599,,1,1,2,1,2,3,2,0.666667,0.75,0.000011,13,0.000651,0
1370387662956298240,1370387662956298240,,1,0,1,1,0,1,0,0,0,0,13,0.000651,0
2297955914,2297955914,,1,0,1,1,0,1,0,0,0,0,13,0.000651,0
1552680427,1552680427,,1,3,4,1,3,4,2,0.714286,0.8,0.000006,13,0.000651,0.03865
1449851498037448704,1449851498037448704,,1,1,2,1,1,2,1,1,1,0,13,0.000651,0.000584
706097800040357888,706097800040357888,,1,1,2,1,1,2,1,1,1,0,21,0.000651,0.000866
1418591216938196992,1418591216938196992,,1,1,2,1,1,2,2,0.666667,0.75,0,13,0.000651,0.020692
547078405,547078405,,1,0,1,1,0,1,0,0,0,0,13,0.000651,0
1077603637285847040,1077603637285847040,,1,0,1,1,0,1,0,0,0,0,13,0.000651,0
1094396285069807616,1094396285069807616,,1,2,3,1,2,3,2,0.75,0.833333,0,13,0.000651,0.021277
1392230741875040256,1392230741875040256,,2,4,6,2,4,6,6,0.39369,0.436353,0.000026,13,0.000861,0.043351
395594857,395594857,,2,0,2,2,0,2,0,0,0,0,13,0.000861,0
9371272,9371272,,2,0,2,2,0,2,0,0,0,0,13,0.000861,0
1409849444,1409849444,,1,1,2,1,2,3,2,0.666667,0.75,0,13,0.000651,0.017924
444837039,444837039,,1,1,2,1,1,2,2,0.666667,0.75,0,13,0.000651,0.020692
561271539,561271539,,1,2,3,1,3,4,2,0.75,0.833333,0,13,0.000651,0.021369
388245923,388245923,,1,0,1,1,0,1,0,0,0,0,13,0.000651,0
432513377,432513377,,2,5,7,2,5,7,7,0.288823,0.313421,0.000036,21,0.000861,0.024265
1390709299920449536,1390709299920449536,,2,1,3,2,1,3,1,1,1,0.000006,28,0.000653,0
1360623190620397568,1360623190620397568,,1,0,1,1,0,1,0,0,0,0,13,0.000651,0
1327205063614410752,1327205063614410752,,1,0,1,1,0,1,0,0,0,0,13,0.000651,0
1412077352918601728,1412077352918601728,,1,2,3,1,2,3,2,0.666667,0.75,0,13,0.000651,0.038617
730842345579675648,730842345579675648,,1,0,1,1,0,1,0,0,0,0,13,0.000651,0
76993549,76993549,,1,2,3,1,2,3,7,0.272895,0.306349,0.000011,14,0.000651,0.020059
832242520864280576,832242520864280576,,1,0,1,1,0,1,0,0,0,0,13,0.000651,0
902615969150926848,902615969150926848,,1,0,1,1,0,1,0,0,0,0,13,0.000651,0
1376839147625844736,1376839147625844736,,2,1,3,2,1,3,7,0.283203,0.300698,0,9,0.000861,0.004809
279496623,279496623,,1,0,1,1,0,1,0,0,0,0,13,0.000651,0
831782232905936896,831782232905936896,,1,1,2,1,1,2,2,0.666667,0.75,0,13,0.000651,0.020692
1235509851675033600,1235509851675033600,,1,0,1,1,0,1,0,0,0,0,13,0.000651,0
1333682800948547584,1333682800948547584,,1,2,3,1,2,3,8,0.303546,0.34345,0.000019,13,0.000651,0.025483
1279571653249380352,1279571653249380352,,1,1,2,1,1,2,2,0.666667,0.75,0,13,0.000651,0.017924
1006406222164185088,1006406222164185088,,1,1,2,1,1,2,1,1,1,0.000003,13,0.000651,0.000132
721290831261470720,721290831261470720,,1,0,1,1,0,1,0,0,0,0,13,0.000651,0
2876969818,2876969818,,1,1,2,1,1,2,1,1,1,0.000006,18,0.000651,0.00001
325606060,325606060,,1,0,1,1,0,1,0,0,0,0,13,0.000651,0
712537649794428928,712537649794428928,,1,0,1,1,0,1,0,0,0,0,13,0.000651,0
2360365059,2360365059,,1,2,3,1,2,3,2,0.75,0.833333,0,15,0.000651,0.019393
812789625462865920,812789625462865920,,1,0,1,1,0,1,0,0,0,0,13,0.000651,0
521164308,521164308,,1,0,1,1,0,1,0,0,0,0,13,0.000651,0
3422534909,3422534909,,2,1,3,2,1,3,2,0.666667,0.75,0,13,0.000861,0.017924
1412187597514985472,1412187597514985472,,2,1,3,2,1,3,2,0.666667,0.75,0,13,0.000861,0.017924
1143393739,1143393739,,2,1,3,2,1,3,2,0.666667,0.75,0,13,0.000861,0.017924
3074560906,3074560906,,1,1,2,1,1,2,2,0.666667,0.75,0,13,0.000651,0.020692
1322184236,1322184236,,1,2,3,1,2,3,1,1,1,0.000001,9,0.000651,0.003753
1392903139779620864,1392903139779620864,,2,0,2,2,0,2,0,0,0,0,14,0.000662,0
1248373124778921984,1248373124778921984,,1,0,1,1,0,1,0,0,0,0,13,0.000651,0
2773205240,2773205240,,1,2,3,1,2,3,2,0.666667,0.75,0,13,0.000651,0.038617
594793423,594793423,,1,0,1,1,0,1,0,0,0,0,13,0.000651,0
513576447,513576447,,1,1,2,1,1,2,2,0.666667,0.75,0,13,0.000651,0.020692
1425823584082034688,1425823584082034688,,1,0,1,1,0,1,0,0,0,0,13,0.000651,0
2324171570,2324171570,,2,2,4,3,4,7,1,1,1,0.000011,13,0.001197,0
278425671,278425671,,2,1,3,3,1,4,1,1,1,0.000004,14,0.0007,0.000129
1130395706156568576,1130395706156568576,,1,3,4,1,3,4,8,0.303986,0.344543,0.000019,13,0.000651,0.043407
1377619729137946624,1377619729137946624,,1,2,3,1,2,3,2,0.666667,0.75,0,13,0.000651,0.038617
385872805,385872805,,1,0,1,1,0,1,0,0,0,0,13,0.000651,0
1439519096975073280,1439519096975073280,,1,0,1,1,0,1,0,0,0,0,13,0.000651,0
1361873214952136704,1361873214952136704,,1,1,2,1,1,2,2,0.666667,0.75,0,13,0.000651,0.017924
792173359,792173359,,1,0,1,1,0,1,0,0,0,0,13,0.000651,0
2184531680,2184531680,,1,0,1,1,0,1,0,0,0,0,13,0.000651,0
1524453986,1524453986,,2,3,5,2,3,5,7,0.285294,0.306537,0.000003,15,0.000861,0.025791
174210451,174210451,,2,1,3,2,2,4,1,1,1,0.000006,250,0.000655,0.000015
1351166954497859584,1351166954497859584,,1,0,1,1,0,1,0,0,0,0,13,0.000651,0
1353812106,1353812106,,1,1,2,1,1,2,1,1,1,0.000006,13,0.000651,0
1171740218321510400,1171740218321510400,,1,0,1,1,0,1,0,0,0,0,13,0.000651,0
1475611711,1475611711,,1,0,1,1,0,1,0,0,0,0,13,0.000651,0
1152958669883084800,1152958669883084800,,0,3,3,0,3,3,7,0.2846,0.305488,0,9,0,0.004904
1109178580049846272,1109178580049846272,,0,1,1,0,1,1,2,0.666667,0.75,0,18,0,0.000016
1067008310,1067008310,,0,4,4,0,4,4,7,0.286602,0.310224,0,21,0,0.006222
1355567367431081984,1355567367431081984,,0,1,1,0,1,1,1,1,1,0,206,0,0.000067
3610762348,3610762348,,1,0,1,1,0,1,0,0,0,0,18,0,0
362470970,362470970,,0,1,1,0,1,1,1,1,1,0,28,0,0.000001
305812698,305812698,,0,1,1,0,1,1,8,0.239742,0.254313,0,250,0,0.000495
22494840,22494840,,3,1,4,3,1,4,2,0.666667,0.75,0,13,0.000631,0.017924
2346386829,2346386829,,0,3,3,0,3,3,2,0.666667,0.75,0,18,0,0.020763
1436278412209967104,1436278412209967104,,2,0,2,2,0,2,0,0,0,0,18,0.000607,0
184373505,184373505,,0,1,1,0,1,1,1,1,1,0,206,0,0.000067
1135103330357796864,1135103330357796864,,0,1,1,0,1,1,1,1,1,0,28,0,0.000001
255936660,255936660,,0,0,0,0,0,0,0,0,0,0,135,0,0
1344373356590731264,1344373356590731264,,0,1,1,0,1,1,1,1,1,0,28,0,0.000001
1362899216855670784,1362899216855670784,,0,1,1,0,1,1,2,0.666667,0.75,0,5,0,0.020692
2472325534,2472325534,,0,1,1,0,1,1,1,1,1,0,14,0,0
724665714188161024,724665714188161024,,0,1,1,0,1,1,8,0.239742,0.254313,0,250,0,0.000495
497384675,497384675,,0,1,1,0,1,1,8,0.239742,0.254313,0,250,0,0.000495
1308784357545578496,1308784357545578496,,1,0,1,2,0,2,0,0,0,0,18,0,0
161649422,161649422,,0,1,1,0,1,1,2,0.666667,0.75,0,18,0,0.000015
1704888342,1704888342,,0,1,1,0,1,1,8,0.239742,0.254313,0,250,0,0.000495
1424657380629958656,1424657380629958656,,1,0,1,1,0,1,0,0,0,0,18,0,0
1429348800536195072,1429348800536195072,,0,1,1,0,1,1,1,1,1,0,18,0,0.000038
2801911624,2801911624,,0,1,1,0,1,1,1,1,1,0,206,0,0.000067
1350769135182086144,1350769135182086144,,6,0,6,6,0,6,0,0,0,0,28,0.000003,0
2786653664,2786653664,,0,1,1,0,1,1,8,0.239742,0.254313,0,250,0,0.000495
557037685,557037685,,0,1,1,0,1,1,2,0.666667,0.75,0,136,0,0
2876192128,2876192128,,1,1,2,1,1,2,1,1,1,0,136,0,0
465471132,465471132,,0,1,1,0,3,3,2,0.666667,0.75,0,18,0,0.000016
1442401413393383424,1442401413393383424,,0,0,0,0,0,0,0,0,0,0,137,0,0
1408753351660130304,1408753351660130304,,0,1,1,0,1,1,2,0.666667,0.75,0,33,0,0.000004
1397982227925975040,1397982227925975040,,3,1,4,4,2,6,1,1,1,0,33,0.000122,0
1392039763,1392039763,,0,1,1,0,1,1,8,0.239742,0.254313,0,250,0,0.000495
16777774,16777774,,0,1,1,0,1,1,1,1,1,0,14,0,0
1422988447720034304,1422988447720034304,,0,1,1,0,1,1,1,1,1,0,14,0,0
532222780,532222780,,0,2,2,0,2,2,8,0.239871,0.254935,0,250,0,0.021188
1320369556335087616,1320369556335087616,,0,2,2,0,2,2,9,0.18408,0.196644,0,18,0,0.021662
20400130,20400130,,0,0,0,0,0,0,0,0,0,0,138,0,0
978643184,978643184,,0,1,1,0,1,1,1,1,1,0,28,0,0.00006
1443675427554406400,1443675427554406400,,0,1,1,0,1,1,1,1,1,0,28,0,0.000001
2888006819,2888006819,,0,2,2,0,2,2,1,1,1,0,18,0,0.000039
910585294667304960,910585294667304960,,0,1,1,0,1,1,1,1,1,0,139,0,0
3001832471,3001832471,,1,0,1,1,0,1,0,0,0,0,139,0,0
1249678210314502144,1249678210314502144,,0,1,1,0,1,1,8,0.239742,0.254313,0,250,0,0.000495
82976875,82976875,,0,0,0,0,0,0,0,0,0,0,140,0,0
36039763,36039763,,0,1,1,0,1,1,8,0.239742,0.254313,0,250,0,0.000495
1440660636657065984,1440660636657065984,,0,1,1,0,1,1,8,0.246116,0.260917,0,14,0,0.000541
541670926,541670926,,0,1,1,0,2,2,8,0.239742,0.254313,0,250,0,0.000495
2764665148,2764665148,,1,1,2,1,1,2,2,0.666667,0.75,0.000001,18,0,0.017924
2656932553,2656932553,,1,0,1,1,0,1,0,0,0,0,18,0,0
634636448,634636448,,1,0,1,1,0,1,0,0,0,0,18,0,0
94788246,94788246,,1,1,2,1,1,2,7,0.283203,0.300698,0.000174,18,0,0.004809
422062831,422062831,,0,1,1,0,1,1,1,1,1,0,18,0,0.000038
532572724,532572724,,1,1,2,2,1,3,2,0.666667,0.75,0,18,0.00014,0.020692
1020575569287708672,1020575569287708672,,2,1,3,4,2,6,1,1,1,0,18,0.000047,0
1078714763323105280,1078714763323105280,,0,0,0,0,0,0,0,0,0,0,141,0,0
917038232,917038232,,0,3,3,0,3,3,2,0.8,0.875,0,13,0,0.021501
898543969797275648,898543969797275648,,0,1,1,0,1,1,8,0.239742,0.254313,0,250,0,0.000495
1267933116880084992,1267933116880084992,,0,1,1,0,1,1,1,1,1,0,9,0,0.00005
510284434,510284434,,2,0,2,5,0,5,0,0,0,0,28,0,0
553143096,553143096,,0,1,1,0,1,1,1,1,1,0,18,0,0.000018
441849135,441849135,,0,0,0,0,0,0,0,0,0,0,142,0,0
1252982094596358144,1252982094596358144,,1,0,1,1,0,1,0,0,0,0,28,0,0
337730822,337730822,,0,1,1,0,1,1,4,0.4,0.520833,0,28,0,0.000015
1272712532,1272712532,,0,2,2,0,2,2,8,0.312565,0.354103,0,14,0,0.005332
1946899837,1946899837,,1,0,1,1,0,1,0,0,0,0,250,0.000004,0
1398098581236682752,1398098581236682752,,1,0,1,1,0,1,0,0,0,0,250,0.000004,0
765555246,765555246,,1,1,2,1,1,2,2,0.666667,0.75,0,250,0.000004,0.020692
2331775274,2331775274,,1,0,1,1,0,1,0,0,0,0,250,0.000004,0
435279526,435279526,,1,0,1,2,0,2,0,0,0,0,250,0.000004,0
161776806,161776806,,1,0,1,2,0,2,0,0,0,0,250,0.000004,0
2163541074,2163541074,,1,0,1,1,0,1,0,0,0,0,250,0.000004,0
923144558011133952,923144558011133952,,1,2,3,1,2,3,8,0.316246,0.358865,0.000187,15,0.000004,0.00638
725771229102243840,725771229102243840,,1,0,1,1,0,1,0,0,0,0,250,0.000004,0
703288128681996288,703288128681996288,,1,2,3,1,3,4,2,0.6,0.666667,0.000021,250,0.000004,0.02071
458506443,458506443,,1,0,1,1,0,1,0,0,0,0,250,0.000004,0
250085208,250085208,,1,0,1,1,0,1,0,0,0,0,250,0.000004,0
1192260607,1192260607,,1,0,1,1,0,1,0,0,0,0,250,0.000004,0
400273310,400273310,,1,0,1,1,0,1,0,0,0,0,250,0.000004,0
299780153,299780153,,1,1,2,1,1,2,2,0.666667,0.75,0.000001,250,0.000004,0.017924
1383655178,1383655178,,1,0,1,1,0,1,0,0,0,0,250,0.000004,0
968090647608676352,968090647608676352,,1,0,1,1,0,1,0,0,0,0,250,0.000004,0
85793150,85793150,,1,0,1,1,0,1,0,0,0,0,250,0.000004,0
220657844,220657844,,1,0,1,1,0,1,0,0,0,0,250,0.000004,0
1133644491313876992,1133644491313876992,,1,1,2,1,1,2,1,1,1,0.000001,15,0.000004,0.00039
1336964342823129088,1336964342823129088,,1,0,1,1,0,1,0,0,0,0,250,0.000004,0
323239274,323239274,,1,0,1,1,0,1,0,0,0,0,250,0.000004,0
566361704,566361704,,1,0,1,1,0,1,0,0,0,0,250,0.000004,0
841701064118284288,841701064118284288,,1,0,1,1,0,1,0,0,0,0,250,0.000004,0
1065254220,1065254220,,1,0,1,1,0,1,0,0,0,0,250,0.000004,0
118183154,118183154,,1,0,1,1,0,1,0,0,0,0,250,0.000004,0
1356627301811781632,1356627301811781632,,1,0,1,1,0,1,0,0,0,0,250,0.000004,0
2648108607,2648108607,,1,0,1,1,0,1,0,0,0,0,250,0.000004,0
1316630180,1316630180,,1,0,1,1,0,1,0,0,0,0,250,0.000004,0
1136328033105862656,1136328033105862656,,1,0,1,1,0,1,0,0,0,0,250,0.000004,0
1300098478870233088,1300098478870233088,,1,0,1,1,0,1,0,0,0,0,250,0.000004,0
713088463663456256,713088463663456256,,1,0,1,1,0,1,0,0,0,0,250,0.000004,0
416574932,416574932,,1,0,1,1,0,1,0,0,0,0,250,0.000004,0
910354814,910354814,,1,0,1,1,0,1,0,0,0,0,250,0.000004,0
516238138,516238138,,1,0,1,1,0,1,0,0,0,0,250,0.000004,0
4184406562,4184406562,,1,0,1,1,0,1,0,0,0,0,250,0.000004,0
2437846648,2437846648,,2,0,2,2,0,2,0,0,0,0,250,0.000214,0
469403771,469403771,,1,0,1,1,0,1,0,0,0,0,250,0.000004,0
220603109,220603109,,1,0,1,1,0,1,0,0,0,0,250,0.000004,0
273316238,273316238,,1,0,1,1,0,1,0,0,0,0,250,0.000004,0
849290722566123520,849290722566123520,,1,0,1,1,0,1,0,0,0,0,250,0.000004,0
1299758229715595264,1299758229715595264,,1,0,1,1,0,1,0,0,0,0,250,0.000004,0
1082281620546179072,1082281620546179072,,1,0,1,1,0,1,0,0,0,0,250,0.000004,0
233614695,233614695,,1,2,3,1,2,3,5,0.450688,0.473198,0.001847,250,0.000004,0.01797
1226537390690521088,1226537390690521088,,1,1,2,1,1,2,1,1,1,0.000005,250,0.000004,0.000003
201789369,201789369,,1,1,2,1,1,2,8,0.303216,0.342457,0.000149,250,0.000004,0.00479
1387370190556573696,1387370190556573696,,2,3,5,2,3,5,6,0.394947,0.43541,0.000108,15,0.000214,0.009306
1264018218,1264018218,,1,0,1,1,0,1,0,0,0,0,250,0.000004,0
965276915299966976,965276915299966976,,1,0,1,1,0,1,0,0,0,0,250,0.000004,0
838748535944269824,838748535944269824,,1,0,1,1,0,1,0,0,0,0,250,0.000004,0
3325032107,3325032107,,1,0,1,1,0,1,0,0,0,0,250,0.000004,0
855530862020046848,855530862020046848,,1,0,1,1,0,1,0,0,0,0,250,0.000004,0
1699269889,1699269889,,1,0,1,1,0,1,0,0,0,0,250,0.000004,0
361403479,361403479,,1,0,1,1,0,1,0,0,0,0,250,0.000004,0
1336407070468419584,1336407070468419584,,1,1,2,1,1,2,1,1,1,0.000001,37,0.000004,0.003445
391034680,391034680,,1,0,1,1,0,1,0,0,0,0,250,0.000004,0
4119906531,4119906531,,1,0,1,1,0,1,0,0,0,0,250,0.000004,0
54854463,54854463,,1,0,1,1,0,1,0,0,0,0,250,0.000004,0
2352972501,2352972501,,1,0,1,1,0,1,0,0,0,0,250,0.000004,0
256512993,256512993,,1,0,1,1,0,1,0,0,0,0,250,0.000004,0
464612109,464612109,,2,0,2,2,0,2,0,0,0,0,250,0.000004,0
904262833361362944,904262833361362944,,1,1,2,1,1,2,2,0.666667,0.75,0,250,0.000004,0.020692
934140177571868672,934140177571868672,,1,0,1,1,0,1,0,0,0,0,250,0.000004,0
958474775202058240,958474775202058240,,1,0,1,1,0,1,0,0,0,0,250,0.000004,0
319095713,319095713,,1,0,1,1,0,1,0,0,0,0,250,0.000004,0
1251605058,1251605058,,1,0,1,1,0,1,0,0,0,0,250,0.000004,0
1373003899,1373003899,,1,0,1,1,0,1,0,0,0,0,250,0.000004,0
1405789050,1405789050,,1,0,1,1,0,1,0,0,0,0,250,0.000004,0
2553289698,2553289698,,1,0,1,1,0,1,0,0,0,0,250,0.000004,0
1376231742646931456,1376231742646931456,,2,0,2,2,0,2,0,0,0,0,9,0.000635,0
1442246886266601472,1442246886266601472,,2,1,3,2,1,3,1,1,1,0.000001,14,0.000214,0.001513
1196788331927015424,1196788331927015424,,2,0,2,2,0,2,0,0,0,0,14,0.000005,0
1027951161377214464,1027951161377214464,,1,0,1,1,0,1,0,0,0,0,250,0.000004,0
242922585,242922585,,1,0,1,1,0,1,0,0,0,0,250,0.000004,0
1337596044,1337596044,,1,0,1,1,0,1,0,0,0,0,250,0.000004,0
1083680015492022272,1083680015492022272,,1,0,1,1,0,1,0,0,0,0,250,0.000004,0
2628952445,2628952445,,1,0,1,1,0,1,0,0,0,0,250,0.000004,0
522457817,522457817,,1,0,1,1,0,1,0,0,0,0,250,0.000004,0
130270574,130270574,,1,0,1,1,0,1,0,0,0,0,250,0.000004,0
947879034,947879034,,1,0,1,1,0,1,0,0,0,0,250,0.000004,0
104873862,104873862,,0,4,4,0,4,4,7,0.276699,0.29611,0,206,0,0.000133
1397552279738273792,1397552279738273792,,2,4,6,2,5,7,8,0.317395,0.361216,0.000011,206,0.000144,0.027096
1417095125617029120,1417095125617029120,,2,2,4,2,2,4,6,0.391484,0.431813,0.000016,206,0.000214,0.007594
10228272,10228272,,3,0,3,3,0,3,0,0,0,0,18,0.000622,0
1073496504378290176,1073496504378290176,,0,2,2,0,2,2,1,1,1,0,28,0,0.000001
568318054,568318054,,1,0,1,1,0,1,0,0,0,0,28,0,0
1006901293351305216,1006901293351305216,,0,1,1,0,1,1,8,0.246116,0.260917,0,14,0,0.000541
79238589,79238589,,0,1,1,0,1,1,1,1,1,0,28,0,0.000001
1025143716,1025143716,,0,7,7,0,7,7,8,0.284507,0.324995,0,14,0,0.043744
575630635,575630635,,0,0,0,0,0,0,0,0,0,0,143,0,0
116750021,116750021,,1,1,2,2,1,3,2,0.666667,0.75,0,28,0,0.020692
277617377,277617377,,0,1,1,0,1,1,8,0.246116,0.260917,0,14,0,0.000541
991693594531651584,991693594531651584,,0,0,0,0,0,0,0,0,0,0,144,0,0
57320069,57320069,,1,0,1,2,0,2,0,0,0,0,14,0.000011,0
978660801241403392,978660801241403392,,2,0,2,2,0,2,0,0,0,0,14,0.000642,0
750815910022242304,750815910022242304,,1,0,1,1,0,1,0,0,0,0,14,0.000011,0
488844512,488844512,,2,3,5,3,3,6,3,0.508197,0.537634,0.000027,14,0.000019,0.018961
1168168001096552448,1168168001096552448,,1,3,4,1,3,4,2,0.666667,0.75,0.000012,21,0.000011,0.018889
1324230318887473152,1324230318887473152,,1,0,1,1,0,1,0,0,0,0,14,0.000011,0
1048082142004240384,1048082142004240384,,1,0,1,1,0,1,0,0,0,0,14,0.000011,0
343442484,343442484,,1,0,1,1,0,1,0,0,0,0,14,0.000011,0
751280479,751280479,,1,2,3,1,2,3,7,0.272727,0.306162,0.000011,21,0.000011,0.003083
1263042661,1263042661,,1,5,6,1,6,7,7,0.286413,0.310987,0.000006,13,0.000011,0.026356
1118021347102330880,1118021347102330880,,1,0,1,1,0,1,0,0,0,0,14,0.000011,0
1051983271503036416,1051983271503036416,,1,10,11,1,11,12,7,0.306748,0.361228,0.00005,14,0.000011,0.02816
1248766388354850816,1248766388354850816,,1,0,1,1,0,1,0,0,0,0,14,0.000011,0
1272437335,1272437335,,1,3,4,1,3,4,4,0.419355,0.519231,0.000005,14,0.000011,0.019526
127302531,127302531,,1,0,1,1,0,1,0,0,0,0,14,0.000011,0
703708224168599552,703708224168599552,,2,2,4,2,2,4,1,1,1,0.000001,21,0.000014,0.002379
1183534806,1183534806,,1,0,1,1,0,1,0,0,0,0,14,0.000011,0
1236343528747347968,1236343528747347968,,1,0,1,1,0,1,0,0,0,0,14,0.000011,0
253474831,253474831,,1,0,1,1,0,1,0,0,0,0,14,0.000011,0
1020502986,1020502986,,3,2,5,3,2,5,2,0.75,0.833333,0.000002,15,0.00065,0.019393
1043948268932214784,1043948268932214784,,2,0,2,2,0,2,0,0,0,0,14,0.000642,0
21668842,21668842,,1,3,4,1,3,4,4,0.485294,0.522727,0.000012,14,0.000011,0.001099
1154371862606098432,1154371862606098432,,1,1,2,1,1,2,1,1,1,0,25,0.000011,0.00062
49002471,49002471,,1,0,1,1,0,1,0,0,0,0,14,0.000011,0
142210315,142210315,,1,1,2,1,1,2,1,1,1,0,14,0.000011,0.003445
513444329,513444329,,1,1,2,1,1,2,2,0.666667,0.75,0,14,0.000011,0.017924
2958925781,2958925781,,1,0,1,1,0,1,0,0,0,0,14,0.000011,0
1143894122765438976,1143894122765438976,,1,2,3,1,3,4,1,1,1,0.000006,14,0.000011,0.003448
1006057344042766336,1006057344042766336,,1,4,5,1,4,5,2,0.833333,0.9,0,13,0.000011,0.023422
1614964946,1614964946,,1,2,3,1,3,4,2,0.625,0.7,0.000012,14,0.000011,0.02071
1146147427,1146147427,,1,2,3,1,2,3,1,1,1,0.000001,5,0.000011,0.000305
454661242,454661242,,1,0,1,1,0,1,0,0,0,0,14,0.000011,0
1234744238228803584,1234744238228803584,,1,3,4,1,5,6,7,0.273231,0.307851,0.000011,13,0.000011,0.021528
1367203155440771072,1367203155440771072,,1,2,3,1,2,3,2,0.75,0.833333,0.000004,37,0.000011,0.000347
1022925477504270336,1022925477504270336,,2,4,6,2,5,7,3,0.529412,0.666667,0.000054,9,0.000221,0.005255
1313067100454490112,1313067100454490112,,2,0,2,2,0,2,0,0,0,0,14,0.000013,0
326376163,326376163,,1,1,2,1,1,2,1,1,1,0.000001,5,0.000011,0.000243
1974993666,1974993666,,2,0,2,2,0,2,0,0,0,0,14,0.000013,0
970409903033651200,970409903033651200,,1,0,1,1,0,1,0,0,0,0,14,0.000011,0
1321801194294157312,1321801194294157312,,1,0,1,1,0,1,0,0,0,0,14,0.000011,0
4259706735,4259706735,,1,0,1,1,0,1,0,0,0,0,14,0.000011,0
345219705,345219705,,1,0,1,1,0,1,0,0,0,0,14,0.000011,0
91598969,91598969,,0,1,1,0,1,1,1,1,1,0,28,0,0.000001
54612165,54612165,,1,0,1,1,0,1,0,0,0,0,136,0,0
896190620,896190620,,1,0,1,1,0,1,0,0,0,0,9,0.000606,0
2322670973,2322670973,,0,0,0,0,0,0,0,0,0,0,145,0,0
126359396,126359396,,0,0,0,0,0,0,0,0,0,0,146,0,0
1269024261244628992,1269024261244628992,,0,0,0,0,0,0,0,0,0,0,147,0,0
991615904063655936,991615904063655936,,0,0,0,0,0,0,0,0,0,0,148,0,0
2499922459,2499922459,,0,2,2,0,2,2,2,0.75,0.833333,0,13,0,0.01794
2961784235,2961784235,,2,0,2,3,0,3,0,0,0,0,13,0.000524,0
34747554,34747554,,0,0,0,0,0,0,0,0,0,0,149,0,0
1026003409,1026003409,,1,0,1,1,0,1,0,0,0,0,28,0.000002,0
836972174539911168,836972174539911168,,2,0,2,2,0,2,0,0,0,0,28,0.000003,0
372114824,372114824,,1,1,2,1,1,2,1,1,1,0,28,0.000002,0.000003
1254832039,1254832039,,1,1,2,1,1,2,1,1,1,0,28,0.000002,0
1267892826077122560,1267892826077122560,,1,5,6,1,7,8,5,0.452982,0.477553,0.000006,28,0.000002,0.000046
1347870432100233216,1347870432100233216,,1,0,1,1,0,1,0,0,0,0,28,0.000002,0
1007961299240804352,1007961299240804352,,0,0,0,0,0,0,0,0,0,0,150,0,0
158753027,158753027,,0,1,1,0,1,1,2,0.666667,0.75,0,18,0,0
479745834,479745834,,0,2,2,0,2,2,3,0.555556,0.666667,0,304,0,0.000057
1264967335,1264967335,,0,0,0,0,0,0,0,0,0,0,151,0,0
1726093388,1726093388,,1,0,1,1,0,1,0,0,0,0,28,0,0
1068659585718894592,1068659585718894592,,0,0,0,0,0,0,0,0,0,0,152,0,0
440129895,440129895,,3,0,3,3,0,3,0,0,0,0,28,0.000005,0
2612237397,2612237397,,0,1,1,0,2,2,1,1,1,0,153,0,0
407543535,407543535,,1,0,1,2,0,2,0,0,0,0,153,0,0
20437369,20437369,,0,1,1,0,1,1,1,1,1,0,28,0,0.00006
722919613,722919613,,0,1,1,0,1,1,1,1,1,0,28,0,0.00006
1134111838541615104,1134111838541615104,,0,0,0,0,0,0,0,0,0,0,154,0,0
27269235,27269235,,0,1,1,0,1,1,1,1,1,0,28,0,0.000001
945102892956086272,945102892956086272,,1,2,3,1,2,3,7,0.284035,0.303284,0,21,0.000001,0.008253
1186406702,1186406702,,2,4,6,2,4,6,6,0.396927,0.437742,0.000165,17,0.000211,0.005284
8111252,8111252,,0,1,1,0,1,1,1,1,1,0,28,0,0.000001
721103559,721103559,,0,0,0,0,0,0,0,0,0,0,155,0,0
4875964570,4875964570,,0,1,1,0,1,1,1,1,1,0,13,0,0.000017
1000346763360919552,1000346763360919552,,0,2,2,0,2,2,2,0.75,0.833333,0,28,0,0.000021
437704468,437704468,,0,0,0,0,0,0,0,0,0,0,156,0,0
2430808297,2430808297,,0,4,4,0,4,4,8,0.316981,0.36072,0,13,0,0.024437
1189120928418017280,1189120928418017280,,0,0,0,0,0,0,0,0,0,0,157,0,0
1190104796,1190104796,,0,0,0,0,0,0,0,0,0,0,158,0,0
227217535,227217535,,0,1,1,0,1,1,1,1,1,0,9,0,0.00005
3309811967,3309811967,,0,0,0,0,0,0,0,0,0,0,159,0,0
1172256394499768320,1172256394499768320,,0,0,0,0,0,0,0,0,0,0,160,0,0
1278627799117508608,1278627799117508608,,0,0,0,0,0,0,0,0,0,0,161,0,0
796379451533750272,796379451533750272,,0,0,0,0,0,0,0,0,0,0,162,0,0
873504593719721984,873504593719721984,,0,1,1,0,1,1,1,1,1,0,13,0,0.000132
64522965,64522965,,0,1,1,0,1,1,1,1,1,0,28,0,0.000001
243627014,243627014,,0,0,0,0,0,0,0,0,0,0,163,0,0
1104675124408733696,1104675124408733696,,0,0,0,0,0,0,0,0,0,0,164,0,0
1450025126934757376,1450025126934757376,,0,0,0,0,0,0,0,0,0,0,165,0,0
2435478787,2435478787,,0,1,1,0,1,1,5,0.425926,0.455797,0,15,0,0.00159
1423184248253652992,1423184248253652992,,0,1,1,0,1,1,2,0.666667,0.75,0,13,0,0.017924
1066193983,1066193983,,0,1,1,0,1,1,1,1,1,0,18,0,0
3601138636,3601138636,,0,0,0,0,0,0,0,0,0,0,166,0,0
1256827069272637440,1256827069272637440,,0,0,0,0,0,0,0,0,0,0,167,0,0
2372866781,2372866781,,0,1,1,0,1,1,1,1,1,0,168,0,0
1106458075182055424,1106458075182055424,,2,0,2,2,0,2,0,0,0,0,168,0,0
761637479141310464,761637479141310464,,0,1,1,0,1,1,1,1,1,0,169,0,0
22628539,22628539,,2,0,2,2,0,2,0,0,0,0,169,0,0
1108677910800617472,1108677910800617472,,0,1,1,0,1,1,1,1,1,0,168,0,0
1327721747886600192,1327721747886600192,,0,1,1,0,1,1,1,1,1,0,170,0,0
1346523482553774080,1346523482553774080,,1,0,1,1,0,1,0,0,0,0,170,0,0
1344793377703931904,1344793377703931904,,0,2,2,0,2,2,2,0.75,0.833333,0,15,0,0.001494
482611925,482611925,,1,0,1,2,0,2,0,0,0,0,15,0,0
1341299679036923904,1341299679036923904,,0,0,0,0,0,0,0,0,0,0,171,0,0
310237130,310237130,,0,0,0,0,0,0,0,0,0,0,172,0,0
236126390,236126390,,0,1,1,0,1,1,1,1,1,0,28,0,0.00006
12240322,12240322,,7,0,7,7,0,7,0,0,0,0,14,0.000652,0
1211606433399095296,1211606433399095296,,0,1,1,0,1,1,5,0.315789,0.347778,0,14,0,0
1441518458689236992,1441518458689236992,,1,3,4,1,5,6,4,0.446154,0.502874,0,14,0,0.001671
1071501209507373056,1071501209507373056,,0,1,1,0,1,1,1,1,1,0,28,0,0.00006
1071493866489044992,1071493866489044992,,0,1,1,0,1,1,2,0.666667,0.75,0,13,0,0.017924
525208007,525208007,,0,1,1,0,1,1,1,1,1,0,28,0,0.00006
513288710,513288710,,0,1,1,0,1,1,1,1,1,0,15,0,0.000129
4893303449,4893303449,,0,1,1,0,1,1,1,1,1,0,15,0,0.000129
79511997,79511997,,0,3,3,0,4,4,5,0.451025,0.474242,0,15,0,0.000111
1174975547614433280,1174975547614433280,,2,2,4,3,2,5,2,0.75,0.833333,0.000002,15,0.000213,0.018214
1421950658190659584,1421950658190659584,,0,2,2,0,2,2,1,1,1,0,15,0,0.001642
2603871727,2603871727,,0,1,1,0,1,1,1,1,1,0,28,0,0.00006
555556029,555556029,,0,3,3,0,3,3,2,0.8,0.875,0,28,0,0.00008
264694093,264694093,,0,1,1,0,1,1,1,1,1,0,28,0,0.00006
84874030,84874030,,0,1,1,0,1,1,1,1,1,0,28,0,0.00006
411813423,411813423,,0,1,1,0,1,1,1,1,1,0,28,0,0.00006
1033990615267270656,1033990615267270656,,4,1,5,4,1,5,2,0.666667,0.75,0.000006,37,0.000627,0
1254021896116539392,1254021896116539392,,0,1,1,0,1,1,1,1,1,0,28,0,0.00006
1445338109428830208,1445338109428830208,,0,2,2,0,3,3,1,1,1,0,28,0,0.000129
712602287458369536,712602287458369536,,2,0,2,4,0,4,0,0,0,0,28,0.000004,0
1132689163969548288,1132689163969548288,,0,1,1,0,1,1,1,1,1,0,28,0,0.00006
1414955644596129792,1414955644596129792,,0,3,3,0,3,3,6,0.392613,0.43403,0,37,0,0.004317
1442614955589521408,1442614955589521408,,0,0,0,0,0,0,0,0,0,0,173,0,0
1341476790783512576,1341476790783512576,,0,1,1,0,1,1,1,1,1,0,28,0,0.00006
2735301707,2735301707,,0,1,1,0,1,1,1,1,1,0,28,0,0.00006
1398701696856080384,1398701696856080384,,0,3,3,0,3,3,7,0.295306,0.338968,0,206,0,0.003843
229653221,229653221,,0,1,1,0,1,1,1,1,1,0,28,0,0.00006
422771616,422771616,,0,0,0,0,0,0,0,0,0,0,174,0,0
232908749,232908749,,0,1,1,0,1,1,1,1,1,0,28,0,0.00006
623716299,623716299,,0,1,1,0,1,1,2,0.666667,0.75,0,5,0,0.020692
3092205375,3092205375,,0,1,1,0,1,1,2,0.666667,0.75,0,21,0,0.00007
1409939277643931648,1409939277643931648,,0,1,1,0,1,1,3,0.5,0.537037,0,14,0,0.000023
210855213,210855213,,0,1,1,0,1,1,1,1,1,0,5,0,0.000237
1220020849652137984,1220020849652137984,,0,2,2,0,2,2,2,0.535714,0.566667,0,57,0,0.000063
751146349,751146349,,0,1,1,0,1,1,1,1,1,0,28,0,0.00006
16117084,16117084,,1,0,1,1,0,1,0,0,0,0,206,0,0
463267294,463267294,,1,0,1,1,0,1,0,0,0,0,206,0,0
1235469317778665472,1235469317778665472,,1,0,1,1,0,1,0,0,0,0,206,0,0
1270444711489257472,1270444711489257472,,1,0,1,1,0,1,0,0,0,0,206,0,0
1436787939732766720,1436787939732766720,,1,0,1,1,0,1,0,0,0,0,206,0,0
1030481148663791616,1030481148663791616,,0,2,2,0,2,2,2,0.75,0.833333,0,14,0,0.02075
110439086,110439086,,0,1,1,0,1,1,1,1,1,0,28,0,0.00006
85049014,85049014,,0,1,1,0,1,1,1,1,1,0,250,0,0.000003
1449454304817995776,1449454304817995776,,0,2,2,0,2,2,3,0.571429,0.708333,0,37,0,0.000034
2801845471,2801845471,,2,0,2,2,0,2,0,0,0,0,37,0.000526,0
18162221,18162221,,0,3,3,0,3,3,3,0.6,0.722222,0,37,0,0.017958
101994359,101994359,,0,1,1,0,1,1,2,0.666667,0.75,0,5,0,0.020692
1291820133615271936,1291820133615271936,,0,1,1,0,1,1,3,0.5,0.583333,0,28,0,0
162192942,162192942,,0,1,1,0,1,1,3,0.5,0.611111,0,37,0,0.000018
1290721278400303104,1290721278400303104,,1,1,2,1,1,2,1,1,1,0,37,0,0.003445
1447617823791108096,1447617823791108096,,0,1,1,0,1,1,2,0.666667,0.75,0,13,0,0.017924
1068180040343580672,1068180040343580672,,0,1,1,0,1,1,8,0.303216,0.342457,0,9,0,0.00479
947779075652968448,947779075652968448,,0,1,1,0,1,1,3,0.5,0.583333,0,28,0,0
818963511422423040,818963511422423040,,0,2,2,0,2,2,3,0.555556,0.666667,0,28,0,0.00003
1241114176275255296,1241114176275255296,,0,1,1,0,1,1,3,0.5,0.583333,0,28,0,0
1146412314251448320,1146412314251448320,,0,2,2,0,2,2,3,0.555556,0.666667,0,28,0,0.000001
201421240,201421240,,0,3,3,0,3,3,3,0.6,0.722222,0,28,0,0.000001
4877587901,4877587901,,8,0,8,8,0,8,0,0,0,0,28,0.000019,0
264944313,264944313,,1,0,1,1,0,1,0,0,0,0,19,0.000668,0
1180237460065996800,1180237460065996800,,0,2,2,0,2,2,3,0.555556,0.666667,0,28,0,0
1380639469980770304,1380639469980770304,,0,1,1,0,1,1,1,1,1,0,175,0,0
636193713,636193713,,2,0,2,2,0,2,0,0,0,0,175,0,0
1289717985037422592,1289717985037422592,,0,1,1,0,1,1,1,1,1,0,133,0,0
317411970,317411970,,0,1,1,0,1,1,1,1,1,0,13,0,0.000003
1141800970755739648,1141800970755739648,,0,0,0,0,0,0,0,0,0,0,176,0,0
369459091,369459091,,0,1,1,0,1,1,1,1,1,0,175,0,0
772434643492691968,772434643492691968,,0,1,1,0,1,1,1,1,1,0,177,0,0
463669474,463669474,,1,0,1,1,0,1,0,0,0,0,177,0,0
1326207923777908736,1326207923777908736,,0,1,1,0,1,1,1,1,1,0,178,0,0
1025043644825444352,1025043644825444352,,1,0,1,1,0,1,0,0,0,0,178,0,0
825344782344056832,825344782344056832,,0,1,1,0,1,1,2,0.666667,0.75,0,13,0,0.017924
893540773144272896,893540773144272896,,0,0,0,0,0,0,0,0,0,0,179,0,0
836846292919848960,836846292919848960,,0,2,2,0,2,2,3,0.5,0.531746,0,28,0,0
283452496,283452496,,0,2,2,0,3,3,3,0.45,0.537037,0,21,0,0.000042
108251833,108251833,,0,0,0,0,0,0,0,0,0,0,180,0,0
744923485772853248,744923485772853248,,0,0,0,0,0,0,0,0,0,0,181,0,0
899216831474520064,899216831474520064,,0,1,1,0,1,1,2,0.666667,0.75,0,5,0,0.020692
468497275,468497275,,0,0,0,0,0,0,0,0,0,0,182,0,0
1321090463013707776,1321090463013707776,,0,1,1,0,1,1,1,1,1,0,183,0,0
1726522556,1726522556,,1,0,1,1,0,1,0,0,0,0,183,0,0
3046946825,3046946825,,0,1,1,0,1,1,1,1,1,0,678,0,0
1574688974,1574688974,,2,0,2,3,0,3,0,0,0,0,678,0,0
895568973789630464,895568973789630464,,2,0,2,2,0,2,0,0,0,0,28,0.000001,0
252184604,252184604,,1,1,2,1,1,2,1,1,1,0,28,0,0.000001
572125780,572125780,,0,2,2,0,3,3,2,0.75,0.833333,0,13,0,0.019438
1242113100238794752,1242113100238794752,,0,0,0,0,0,0,0,0,0,0,184,0,0
443180324,443180324,,0,0,0,0,0,0,0,0,0,0,185,0,0
4870603923,4870603923,,0,1,1,0,1,1,1,1,1,0,28,0,0
748447839215321088,748447839215321088,,0,1,1,0,1,1,1,1,1,0,28,0,0
1731128940,1731128940,,0,1,1,0,1,1,1,1,1,0,133,0,0
1332284698475761664,1332284698475761664,,0,1,1,0,1,1,1,1,1,0,28,0,0
827657531958890496,827657531958890496,,0,1,1,0,1,1,1,1,1,0,28,0,0
4236757960,4236757960,,0,1,1,0,1,1,1,1,1,0,28,0,0
1229483272222183424,1229483272222183424,,0,1,1,0,1,1,1,1,1,0,21,0,0.000023
438694136,438694136,,0,1,1,0,1,1,1,1,1,0,28,0,0
832231143332315136,832231143332315136,,0,1,1,0,1,1,8,0.303216,0.342457,0,9,0,0.00479
1972520815,1972520815,,0,2,2,0,2,2,1,1,1,0,28,0,0.000001
1028524926,1028524926,,0,1,1,0,1,1,1,1,1,0,186,0,0
1315040923538067456,1315040923538067456,,1,0,1,1,0,1,0,0,0,0,186,0,0
1144378664219492352,1144378664219492352,,0,0,0,0,0,0,0,0,0,0,187,0,0
334184525,334184525,,0,0,0,0,0,0,0,0,0,0,188,0,0
847507680,847507680,,0,0,0,0,0,0,0,0,0,0,189,0,0
1687413566,1687413566,,0,1,1,0,1,1,1,1,1,0,133,0,0
1317787853569593344,1317787853569593344,,0,1,1,0,1,1,1,1,1,0,28,0,0
314537220,314537220,,0,1,1,0,1,1,1,1,1,0,133,0,0
393423439,393423439,,0,1,1,0,2,2,2,0.666667,0.75,0,18,0,0
1400465762511310848,1400465762511310848,,0,1,1,0,1,1,1,1,1,0,28,0,0
1193096207675117568,1193096207675117568,,0,2,2,0,3,3,7,0.273504,0.307148,0,25,0,0.00217
1199127172990021632,1199127172990021632,,0,3,3,0,3,3,8,0.303875,0.344344,0,37,0,0.026159
4048644567,4048644567,,0,2,2,0,2,2,1,1,1,0,37,0,0.024137
3977951957,3977951957,,0,1,1,0,1,1,2,0.666667,0.75,0,5,0,0.020692
574653310,574653310,,0,1,1,0,1,1,2,0.666667,0.75,0,13,0,0.017924
1368674738307006464,1368674738307006464,,0,1,1,0,1,1,1,1,1,0,28,0,0
67006079,67006079,,0,1,1,0,1,1,1,1,1,0,190,0,0
1071053071,1071053071,,1,0,1,1,0,1,0,0,0,0,190,0,0
273288605,273288605,,0,4,4,0,4,4,9,0.184867,0.205246,0,5,0,0.020823
715644689622372352,715644689622372352,,1,5,6,1,8,9,8,0.224224,0.254177,0.000007,13,0.000608,0.018994
943045818814169088,943045818814169088,,0,2,2,0,2,2,6,0.391484,0.431813,0,9,0,0.022074
100812291,100812291,,0,0,0,0,0,0,0,0,0,0,191,0,0
1170546561060933632,1170546561060933632,,0,1,1,0,1,1,2,0.666667,0.75,0,5,0,0.020692
1450064372789878784,1450064372789878784,,0,1,1,0,1,1,8,0.303216,0.342457,0,9,0,0.00479
3369517217,3369517217,,0,1,1,0,1,1,8,0.303216,0.342457,0,9,0,0.00479
3090019191,3090019191,,0,2,2,0,2,2,8,0.303655,0.34355,0,9,0,0.022715
294636572,294636572,,0,1,1,0,1,1,2,0.666667,0.75,0,28,0,0.000006
1371696600,1371696600,,0,1,1,0,1,1,2,0.666667,0.75,0,13,0,0.017924
1151805316344025088,1151805316344025088,,0,1,1,0,1,1,2,0.666667,0.75,0,5,0,0.020692
1195557909842841600,1195557909842841600,,1,0,1,1,0,1,0,0,0,0,14,0,0
1393300225503076352,1393300225503076352,,1,0,1,1,0,1,0,0,0,0,14,0,0
1066089827932782592,1066089827932782592,,1,0,1,1,0,1,0,0,0,0,14,0,0
942283626640748544,942283626640748544,,1,0,1,1,0,1,0,0,0,0,14,0,0
1183652220224626688,1183652220224626688,,1,0,1,1,0,1,0,0,0,0,14,0,0
2455763346,2455763346,,3,1,4,3,1,4,1,1,1,0.000017,14,0.000008,0.000019
2323971608,2323971608,,2,0,2,2,0,2,0,0,0,0,14,0.000008,0
1924870082,1924870082,,0,1,1,0,1,1,2,0.666667,0.75,0,5,0,0.020692
1553133290,1553133290,,0,3,3,0,3,3,3,0.583333,0.690476,0,5,0,0.000001
1448002220360933376,1448002220360933376,,1,2,3,1,3,4,2,0.75,0.833333,0,5,0,0.020728
1046435184332222464,1046435184332222464,,1,0,1,1,0,1,0,0,0,0,13,0.000188,0
178462750,178462750,,0,1,1,0,1,1,2,0.666667,0.75,0,13,0,0.017924
1234763760583217152,1234763760583217152,,0,2,2,0,2,2,8,0.229842,0.24726,0,18,0,0.018039
428872886,428872886,,0,1,1,0,1,1,2,0.666667,0.75,0,5,0,0.020692
951842702,951842702,,0,3,3,0,5,5,8,0.303875,0.344344,0,13,0,0.024228
1440581929460396032,1440581929460396032,,0,1,1,0,1,1,2,0.666667,0.75,0,5,0,0.020692
541605451,541605451,,0,1,1,0,1,1,2,0.666667,0.75,0,5,0,0.020692
1243500253174775808,1243500253174775808,,0,4,4,0,4,4,6,0.362106,0.406059,0,9,0,0.047557
399299085,399299085,,0,1,1,0,1,1,2,0.666667,0.75,0,13,0,0.017924
1025028467451199488,1025028467451199488,,0,1,1,0,1,1,8,0.303216,0.342457,0,9,0,0.00479
422593556,422593556,,0,1,1,0,1,1,2,0.666667,0.75,0,13,0,0.017924
1255205371649679360,1255205371649679360,,0,1,1,0,1,1,2,0.666667,0.75,0,5,0,0.020692
1164441014234439680,1164441014234439680,,0,2,2,0,2,2,3,0.5,0.555556,0,28,0,0
810547778644541440,810547778644541440,,0,1,1,0,1,1,1,1,1,0,5,0,0.00007
1171501737716277248,1171501737716277248,,3,0,3,3,0,3,0,0,0,0,5,0.002402,0
28125576,28125576,,0,2,2,0,2,2,2,0.75,0.833333,0,28,0,0
472883767,472883767,,0,2,2,0,3,3,2,0.625,0.7,0,21,0,0.000042
2501851306,2501851306,,0,1,1,0,1,1,2,0.666667,0.75,0,5,0,0.020692
418717321,418717321,,0,1,1,0,1,1,2,0.666667,0.75,0,5,0,0.020692
745699605942312960,745699605942312960,,0,1,1,0,1,1,8,0.303216,0.342457,0,9,0,0.00479
1250166694338801664,1250166694338801664,,0,4,4,0,4,4,7,0.285855,0.308828,0,15,0,0.044894
1344253512939687936,1344253512939687936,,0,4,4,0,4,4,5,0.453039,0.476341,0,28,0,0.000046
1108791123215073280,1108791123215073280,,7,0,7,7,0,7,0,0,0,0,28,0.000001,0
2345206182,2345206182,,0,1,1,0,1,1,1,1,1,0,28,0,0.000001
989109871340675072,989109871340675072,,0,1,1,0,1,1,2,0.666667,0.75,0,5,0,0.020692
4076737581,4076737581,,0,1,1,0,1,1,1,1,1,0,13,0,0.000033
872076729535406080,872076729535406080,,2,0,2,2,0,2,0,0,0,0,13,0.00113,0
45314390,45314390,,0,1,1,0,1,1,1,1,1,0,28,0,0
179199123,179199123,,3,0,3,3,0,3,0,0,0,0,28,0,0
1232613215110074368,1232613215110074368,,0,1,1,0,1,1,2,0.666667,0.75,0,13,0,0.017924
1189654234851090432,1189654234851090432,,0,2,2,0,2,2,3,0.5,0.522222,0,14,0,0.018926
598974424,598974424,,0,1,1,0,1,1,2,0.666667,0.75,0,5,0,0.020692
1166720599521157120,1166720599521157120,,0,1,1,0,1,1,2,0.666667,0.75,0,5,0,0.020692
4872258489,4872258489,,0,1,1,0,1,1,7,0.283203,0.300698,0,9,0,0.004809
623974990,623974990,,0,1,1,0,1,1,8,0.303216,0.342457,0,9,0,0.00479
1217029671587663872,1217029671587663872,,0,1,1,0,1,1,2,0.666667,0.75,0,5,0,0.020692
621326231,621326231,,0,1,1,0,1,1,2,0.666667,0.75,0,13,0,0.017924
486422038,486422038,,0,1,1,0,1,1,2,0.666667,0.75,0,5,0,0.020692
784496699150569472,784496699150569472,,0,2,2,0,2,2,8,0.316246,0.358865,0,15,0,0.00638
1241036373232058368,1241036373232058368,,0,1,1,0,1,1,2,0.666667,0.75,0,13,0,0.017924
1428727407444471808,1428727407444471808,,0,1,1,0,1,1,2,0.666667,0.75,0,5,0,0.020692
181592477,181592477,,0,3,3,0,3,3,8,0.303765,0.344245,0,25,0,0.026103
1067044230693089280,1067044230693089280,,0,1,1,0,1,1,1,1,1,0,28,0,0.000001
731824885916442624,731824885916442624,,0,1,1,0,1,1,2,0.666667,0.75,0,5,0,0.020692
404835865,404835865,,0,1,1,0,1,1,2,0.666667,0.75,0,28,0,0.000006
1448955933305016320,1448955933305016320,,0,1,1,0,1,1,2,0.666667,0.75,0,13,0,0.017924
1119257029724508160,1119257029724508160,,0,1,1,0,1,1,1,1,1,0,28,0,0
1426766646119735296,1426766646119735296,,0,1,1,0,1,1,1,1,1,0,13,0,0.000584
1399991502122668032,1399991502122668032,,0,4,4,0,4,4,6,0.393939,0.436713,0,14,0,0.04428
1889472642,1889472642,,0,5,5,0,7,7,7,0.344842,0.390655,0,15,0,0.026748
738344440851468288,738344440851468288,,0,1,1,0,1,1,2,0.666667,0.75,0,5,0,0.020692
970022552,970022552,,0,2,2,0,2,2,2,0.75,0.833333,0,14,0,0.017948
1379486747474718720,1379486747474718720,,0,1,1,0,1,1,8,0.303216,0.342457,0,9,0,0.00479
1269737563,1269737563,,0,1,1,0,1,1,2,0.666667,0.75,0,13,0,0.017924
1957951376,1957951376,,0,1,1,0,1,1,2,0.666667,0.75,0,5,0,0.020692
991696967448322048,991696967448322048,,0,1,1,0,1,1,2,0.666667,0.75,0,13,0,0.017924
1384446301,1384446301,,0,1,1,0,1,1,2,0.666667,0.75,0,5,0,0.020692
1106858815855775744,1106858815855775744,,0,1,1,0,1,1,2,0.666667,0.75,0,5,0,0.020692
1320884767,1320884767,,0,1,1,0,1,1,8,0.303216,0.342457,0,9,0,0.00479
520548577,520548577,,0,2,2,0,2,2,2,0.75,0.833333,0,18,0,0.018015
1219319688129384448,1219319688129384448,,0,1,1,0,1,1,2,0.666667,0.75,0,5,0,0.020692
407296758,407296758,,0,1,1,0,1,1,1,1,1,0,15,0,0.00007
939404858679091200,939404858679091200,,0,2,2,0,2,2,8,0.303436,0.343252,0,5,0,0.005036
1249842258226053120,1249842258226053120,,0,1,1,0,3,3,2,0.666667,0.75,0,13,0,0.017924
308327933,308327933,,0,1,1,0,1,1,2,0.666667,0.75,0,5,0,0.020692
980916806520049664,980916806520049664,,0,1,1,0,1,1,8,0.303216,0.342457,0,9,0,0.00479
164788311,164788311,,0,1,1,0,1,1,2,0.666667,0.75,0,5,0,0.020692
1436197225428922368,1436197225428922368,,0,2,2,0,2,2,7,0.284742,0.304445,0,206,0,0.004813
1417503189943922688,1417503189943922688,,3,2,5,3,4,7,1,1,1,0.000005,206,0.000148,0
20423071,20423071,,1,0,1,2,0,2,0,0,0,0,18,0.000001,0
385613572,385613572,,1,0,1,2,0,2,0,0,0,0,13,0.000555,0
289836266,289836266,,1,0,1,1,0,1,0,0,0,0,13,0.000555,0
1225152511771914240,1225152511771914240,,0,1,1,0,1,1,8,0.303216,0.342457,0,9,0,0.00479
2155835867,2155835867,,0,0,0,0,0,0,0,0,0,0,192,0,0
2773450417,2773450417,,0,3,3,0,3,3,8,0.31032,0.34967,0,206,0,0.004804
1481534546,1481534546,,0,0,0,0,0,0,0,0,0,0,193,0,0
1250267900,1250267900,,0,1,1,0,1,1,2,0.666667,0.75,0,13,0,0.017924
928545522700443648,928545522700443648,,0,1,1,0,1,1,2,0.666667,0.75,0,5,0,0.020692
1331715182301736960,1331715182301736960,,0,1,1,0,1,1,1,1,1,0,28,0,0
815729427493613568,815729427493613568,,0,1,1,0,1,1,2,0.666667,0.75,0,13,0,0.017924
1004821348730929152,1004821348730929152,,0,4,4,0,4,4,6,0.394483,0.437296,0,21,0,0.043715
1302219819668910080,1302219819668910080,,0,1,1,0,1,1,2,0.666667,0.75,0,5,0,0.020692
2252899982,2252899982,,0,3,3,0,3,3,8,0.318165,0.361746,0,15,0,0.006463
637015768,637015768,,0,1,1,0,1,1,1,1,1,0,28,0,0
435283445,435283445,,0,3,3,0,3,3,7,0.284593,0.305583,0,37,0,0.026178
1069669651175612416,1069669651175612416,,0,1,1,0,1,1,7,0.272226,0.304285,0,14,0,0.002135
448010121,448010121,,0,1,1,0,1,1,1,1,1,0,28,0,0
1132056139611475968,1132056139611475968,,0,1,1,0,1,1,2,0.666667,0.75,0,5,0,0.020692
1243401080,1243401080,,0,1,1,0,1,1,2,0.666667,0.75,0,13,0,0.017924
810996812500889600,810996812500889600,,0,2,2,0,2,2,8,0.303546,0.34345,0,9,0,0.025483
1054851091,1054851091,,0,2,2,0,2,2,7,0.272672,0.305848,0,14,0,0.002158
1858605360,1858605360,,0,1,1,0,1,1,2,0.666667,0.75,0,5,0,0.020692
2505226387,2505226387,,0,1,1,0,1,1,6,0.390411,0.429474,0,9,0,0.00415
627375615,627375615,,0,2,2,0,2,2,2,0.666667,0.75,0,5,0,0.038617
1342448290848268288,1342448290848268288,,0,1,1,0,1,1,2,0.666667,0.75,0,5,0,0.020692
1230483518356103168,1230483518356103168,,0,1,1,0,1,1,7,0.283203,0.300698,0,9,0,0.004809
356704621,356704621,,0,2,2,0,2,2,8,0.303436,0.343252,0,25,0,0.005411
1395882728,1395882728,,0,1,1,0,1,1,2,0.666667,0.75,0,13,0,0.017924
1000843531286609920,1000843531286609920,,0,1,1,0,1,1,2,0.666667,0.75,0,5,0,0.020692
1039545272,1039545272,,0,1,1,0,1,1,2,0.6,0.666667,0,110,0,0.000016
889405652,889405652,,0,1,1,0,1,1,7,0.283203,0.300698,0,9,0,0.004809
1244058540798619648,1244058540798619648,,0,2,2,0,3,3,1,1,1,0,194,0,0
1450193091915390976,1450193091915390976,,1,0,1,2,0,2,0,0,0,0,194,0,0
110960339,110960339,,2,0,2,2,0,2,0,0,0,0,194,0,0
847407677059645440,847407677059645440,,0,1,1,0,1,1,2,0.52381,0.545455,0,18,0,0.000066
1185505633522597888,1185505633522597888,,1,0,1,1,0,1,0,0,0,0,18,0.000001,0
1238099144100777984,1238099144100777984,,0,2,2,0,3,3,2,0.75,0.833333,0,13,0,0.018161
1449522308322938880,1449522308322938880,,0,1,1,0,2,2,2,0.666667,0.75,0,28,0,0.000006
512990070,512990070,,0,1,1,0,1,1,2,0.666667,0.75,0,5,0,0.020692
4372515753,4372515753,,0,1,1,0,1,1,7,0.283203,0.300698,0,9,0,0.004809
70624474,70624474,,0,4,4,0,4,4,8,0.304206,0.345337,0,5,0,0.043644
1144013984795901952,1144013984795901952,,0,1,1,0,1,1,2,0.666667,0.75,0,5,0,0.020692
4602949823,4602949823,,0,1,1,0,1,1,2,0.666667,0.75,0,5,0,0.020692
1355024335,1355024335,,0,2,2,0,2,2,2,0.666667,0.75,0,57,0,0.01794
4185169265,4185169265,,0,2,2,0,2,2,2,0.666667,0.75,0,5,0,0.038617
4416311188,4416311188,,0,1,1,0,1,1,2,0.666667,0.75,0,5,0,0.020692
866019915265921024,866019915265921024,,0,1,1,0,1,1,2,0.666667,0.75,0,5,0,0.020692
42084305,42084305,,0,0,0,0,0,0,0,0,0,0,195,0,0
4910844983,4910844983,,0,1,1,0,1,1,2,0.666667,0.75,0,5,0,0.020692
524453686,524453686,,0,1,1,0,1,1,8,0.303216,0.342457,0,9,0,0.00479
176096395,176096395,,0,1,1,0,1,1,8,0.303216,0.342457,0,9,0,0.00479
1446548415500980224,1446548415500980224,,0,0,0,0,0,0,0,0,0,0,196,0,0
1244928161697214464,1244928161697214464,,0,1,1,0,1,1,2,0.666667,0.75,0,13,0,0.017924
4205262461,4205262461,,0,1,1,0,1,1,1,1,1,0,5,0,0.000237
1959202458,1959202458,,0,2,2,0,2,2,8,0.303546,0.34345,0,9,0,0.025483
1342543513,1342543513,,0,0,0,0,0,0,0,0,0,0,197,0,0
1350404774399778816,1350404774399778816,,0,1,1,0,1,1,2,0.666667,0.75,0,5,0,0.020692
1300011313356312576,1300011313356312576,,0,1,1,0,1,1,2,0.666667,0.75,0,5,0,0.020692
524336857,524336857,,0,1,1,0,1,1,2,0.666667,0.75,0,5,0,0.020692
1178064455047028736,1178064455047028736,,0,1,1,0,1,1,2,0.666667,0.75,0,5,0,0.020692
1390215724048822272,1390215724048822272,,0,1,1,0,1,1,2,0.666667,0.75,0,5,0,0.020692
125374717,125374717,,0,2,2,0,2,2,1,1,1,0,5,0,0.00024
2580853616,2580853616,,2,0,2,2,0,2,0,0,0,0,5,0.000108,0
266608541,266608541,,0,1,1,0,1,1,2,0.666667,0.75,0,5,0,0.020692
695674551661887488,695674551661887488,,0,0,0,0,0,0,0,0,0,0,198,0,0
1437861972071043072,1437861972071043072,,0,2,2,0,2,2,7,0.284035,0.303284,0,25,0,0.005429
1288876471583481856,1288876471583481856,,0,2,2,0,2,2,6,0.391484,0.431813,0,9,0,0.022074
955738795,955738795,,0,1,1,0,1,1,1,1,1,0,28,0,0.000001
1633923900,1633923900,,0,4,4,0,4,4,7,0.345125,0.38129,0,9,0,0.031882
4038647320,4038647320,,0,1,1,0,1,1,2,0.666667,0.75,0,5,0,0.020692
523499856,523499856,,0,1,1,0,1,1,2,0.666667,0.75,0,5,0,0.020692
388196230,388196230,,0,0,0,0,0,0,0,0,0,0,199,0,0
997063214,997063214,,0,0,0,0,0,0,0,0,0,0,200,0,0
857602043585986560,857602043585986560,,0,1,1,0,1,1,2,0.666667,0.75,0,5,0,0.020692
1442492145282084864,1442492145282084864,,0,1,1,0,1,1,2,0.666667,0.75,0,5,0,0.020692
1151801315196116992,1151801315196116992,,1,0,1,1,0,1,0,0,0,0,14,0.000823,0
1239853771120873472,1239853771120873472,,0,1,1,0,1,1,7,0.283203,0.300698,0,9,0,0.004809
4463821833,4463821833,,0,4,4,0,4,4,8,0.316723,0.360455,0,15,0,0.009363
109042655,109042655,,0,1,1,0,2,2,2,0.666667,0.75,0,13,0,0.017924
1066667161,1066667161,,0,1,1,0,1,1,1,1,1,0,5,0,0.000237
583126253,583126253,,0,4,4,0,4,4,2,0.833333,0.9,0,15,0,0.042451
503847121,503847121,,0,1,1,0,1,1,2,0.666667,0.75,0,5,0,0.020692
122653988,122653988,,0,2,2,0,2,2,8,0.303546,0.34345,0,9,0,0.025483
1105912345514131456,1105912345514131456,,1,3,4,2,8,10,1,1,1,0.000016,250,0.000605,0
809764232111783936,809764232111783936,,0,1,1,0,1,1,2,0.666667,0.75,0,5,0,0.020692
96432436,96432436,,0,0,0,0,0,0,0,0,0,0,201,0,0
1333380139716112384,1333380139716112384,,0,1,1,0,1,1,2,0.666667,0.75,0,5,0,0.020692
3018792360,3018792360,,0,2,2,0,2,2,7,0.284457,0.30396,0,9,0,0.025501
312928427,312928427,,0,1,1,0,1,1,2,0.666667,0.75,0,13,0,0.017924
957760032,957760032,,0,1,1,0,1,1,2,0.666667,0.75,0,5,0,0.020692
342074085,342074085,,0,2,2,0,2,2,8,0.303546,0.34345,0,9,0,0.025483
1221425087938748416,1221425087938748416,,0,2,2,0,2,2,2,0.75,0.833333,0,13,0,0.020794
251984583,251984583,,0,1,1,0,1,1,2,0.666667,0.75,0,5,0,0.020692
958710404,958710404,,0,1,1,0,1,1,2,0.666667,0.75,0,5,0,0.020692
131082268,131082268,,0,1,1,0,1,1,2,0.666667,0.75,0,5,0,0.020692
1148946079,1148946079,,0,1,1,0,1,1,2,0.666667,0.75,0,5,0,0.020692
1082608591008399360,1082608591008399360,,0,1,1,0,1,1,2,0.666667,0.75,0,5,0,0.020692
424235813,424235813,,0,1,1,0,1,1,2,0.666667,0.75,0,5,0,0.020692
257925529,257925529,,0,1,1,0,1,1,8,0.303216,0.342457,0,9,0,0.00479
415666601,415666601,,0,2,2,0,2,2,7,0.284035,0.303284,0,15,0,0.006278
1270756624387506176,1270756624387506176,,0,1,1,0,1,1,2,0.666667,0.75,0,5,0,0.020692
1295807244190330880,1295807244190330880,,0,2,2,0,2,2,2,0.75,0.833333,0,15,0,0.022161
4143908721,4143908721,,0,1,1,0,1,1,2,0.666667,0.75,0,13,0,0.017924
1044174354,1044174354,,0,1,1,0,1,1,2,0.666667,0.75,0,5,0,0.020692
1000859842179977216,1000859842179977216,,0,1,1,0,1,1,2,0.666667,0.75,0,5,0,0.020692
1037003822,1037003822,,0,2,2,0,2,2,7,0.272727,0.306162,0,14,0,0.022827
2535282981,2535282981,,0,1,1,0,1,1,2,0.666667,0.75,0,5,0,0.020692
48328393,48328393,,0,1,1,0,1,1,2,0.666667,0.75,0,5,0,0.020692
1226207221396234240,1226207221396234240,,0,1,1,0,1,1,2,0.666667,0.75,0,13,0,0.017924
2365781290,2365781290,,0,1,1,0,1,1,2,0.666667,0.75,0,5,0,0.020692
776564120141324288,776564120141324288,,0,1,1,0,1,1,2,0.666667,0.75,0,5,0,0.020692
1094253615420706816,1094253615420706816,,0,2,2,0,2,2,6,0.391363,0.431264,0,9,0,0.008958
1388854795,1388854795,,0,3,3,0,4,4,2,0.714286,0.8,0,15,0,0.02218
1367150461095194624,1367150461095194624,,1,1,2,2,2,4,1,1,1,0,15,0.000648,0
2328797694,2328797694,,0,4,4,0,4,4,8,0.304238,0.345323,0,5,0,0.043477
3067704269,3067704269,,0,1,1,0,1,1,2,0.666667,0.75,0,5,0,0.020692
1379962796,1379962796,,0,6,6,0,7,7,6,0.376282,0.41096,0,13,0,0.031437
885254905149239296,885254905149239296,,0,1,1,0,1,1,2,0.666667,0.75,0,5,0,0.020692
1315672532578701312,1315672532578701312,,0,2,2,0,2,2,6,0.361326,0.404271,0,9,0,0.00894
964962486775697408,964962486775697408,,0,1,1,0,1,1,2,0.666667,0.75,0,5,0,0.020692
827878978564345856,827878978564345856,,0,1,1,0,1,1,2,0.666667,0.75,0,13,0,0.017924
2405243947,2405243947,,0,2,2,0,2,2,6,0.319654,0.347222,0,14,0,0.006944
65922786,65922786,,0,6,6,0,8,8,5,0.442857,0.484229,0,15,0,0.022977
527804390,527804390,,0,0,0,0,0,0,0,0,0,0,202,0,0
1334587262689009664,1334587262689009664,,0,1,1,0,1,1,8,0.303216,0.342457,0,9,0,0.00479
906161311,906161311,,0,1,1,0,1,1,2,0.666667,0.75,0,5,0,0.020692
1293336665960919040,1293336665960919040,,0,2,2,0,2,2,8,0.303436,0.343252,0,37,0,0.008235
1438202807761440768,1438202807761440768,,0,3,3,0,3,3,8,0.309278,0.351474,0,18,0,0.005903
870472159,870472159,,0,2,2,0,2,2,8,0.303546,0.34345,0,9,0,0.025483
1109639072,1109639072,,0,6,6,0,6,6,6,0.399449,0.443621,0,57,0,0.028385
576996067,576996067,,0,1,1,0,1,1,2,0.666667,0.75,0,5,0,0.020692
400750669,400750669,,0,1,1,0,1,1,2,0.666667,0.75,0,5,0,0.020692
2253510097,2253510097,,0,3,3,0,3,3,6,0.392857,0.434382,0,25,0,0.025463
969807489091981312,969807489091981312,,0,1,1,0,1,1,2,0.666667,0.75,0,5,0,0.020692
1318312469547372544,1318312469547372544,,0,1,1,0,1,1,2,0.666667,0.75,0,13,0,0.017924
3576140957,3576140957,,0,2,2,0,2,2,3,0.538462,0.619048,0,9,0,0.017991
917304116270989312,917304116270989312,,0,1,1,0,1,1,2,0.666667,0.75,0,5,0,0.020692
1188713702478008320,1188713702478008320,,0,1,1,0,1,1,2,0.666667,0.75,0,5,0,0.020692
1004886276,1004886276,,0,1,1,0,3,3,2,0.666667,0.75,0,13,0,0.017924
2407748559,2407748559,,0,2,2,0,2,2,8,0.303546,0.34345,0,9,0,0.025483
1440046801629761536,1440046801629761536,,0,1,1,0,1,1,8,0.303216,0.342457,0,9,0,0.00479
38275728,38275728,,0,1,1,0,1,1,2,0.666667,0.75,0,13,0,0.017924
1193733110,1193733110,,0,2,2,0,2,2,3,0.533333,0.604167,0,15,0,0.018356
51759517,51759517,,0,6,6,0,10,10,2,0.65,0.730769,0,13,0,0.018686
441705033,441705033,,1,0,1,2,0,2,0,0,0,0,13,0.000546,0
203748670,203748670,,0,1,1,0,1,1,2,0.666667,0.75,0,5,0,0.020692
1328720112153747456,1328720112153747456,,0,2,2,0,3,3,7,0.283757,0.302997,0,13,0,0.022733
1356925042978922496,1356925042978922496,,0,1,1,0,1,1,2,0.666667,0.75,0,5,0,0.020692
117172862,117172862,,0,1,1,0,1,1,7,0.283203,0.300698,0,9,0,0.004809
927122457894453248,927122457894453248,,0,4,4,0,4,4,7,0.309245,0.335174,0,14,0,0.028017
1449424682403389440,1449424682403389440,,0,0,0,0,0,0,0,0,0,0,203,0,0
1684468244,1684468244,,0,1,1,0,2,2,2,0.666667,0.75,0,13,0,0.017924
1450180353503678464,1450180353503678464,,0,1,1,0,1,1,7,0.283203,0.300698,0,9,0,0.004809
542811388,542811388,,0,3,3,0,3,3,6,0.362106,0.405463,0,9,0,0.013749
1252461065742569472,1252461065742569472,,0,2,2,0,3,3,2,0.666667,0.75,0,13,0,0.038617
1435137407343550464,1435137407343550464,,3,0,3,3,0,3,0,0,0,0,19,0.000002,0
1444734941045133312,1444734941045133312,,0,1,1,0,1,1,1,1,1,0,15,0,0.00007
2244779704,2244779704,,0,1,1,0,1,1,2,0.666667,0.75,0,5,0,0.020692
216708679,216708679,,0,0,0,0,0,0,0,0,0,0,204,0,0
1349804000217067520,1349804000217067520,,0,3,3,0,3,3,1,1,1,0,33,0,0.024167
1239617807874211840,1239617807874211840,,0,3,3,0,4,4,6,0.320115,0.348724,0,13,0,0.024868
809688687965413376,809688687965413376,,0,1,1,0,1,1,2,0.52381,0.545455,0,18,0,0.000066
354125985,354125985,,0,1,1,0,1,1,2,0.666667,0.75,0,5,0,0.020692
802632247530627072,802632247530627072,,0,1,1,0,1,1,1,1,1,0,19,0,0
1117872400534843392,1117872400534843392,,0,1,1,0,1,1,2,0.666667,0.75,0,5,0,0.020692
4550121561,4550121561,,0,1,1,0,1,1,1,1,1,0,19,0,0
4885456060,4885456060,,0,4,4,0,4,4,8,0.304049,0.345012,0,9,0,0.025526
3662753592,3662753592,,1,0,1,1,0,1,0,0,0,0,9,0.000746,0
493029144,493029144,,1,0,1,1,0,1,0,0,0,0,9,0.000746,0
4372567637,4372567637,,0,1,1,0,1,1,8,0.303216,0.342457,0,9,0,0.00479
3064089189,3064089189,,0,1,1,0,1,1,2,0.666667,0.75,0,5,0,0.020692
553567662,553567662,,0,1,1,0,1,1,2,0.666667,0.75,0,5,0,0.020692
4221418967,4221418967,,0,1,1,0,1,1,2,0.666667,0.75,0,5,0,0.020692
159329355,159329355,,0,1,1,0,1,1,2,0.666667,0.75,0,5,0,0.020692
1335922192920539136,1335922192920539136,,0,1,1,0,1,1,2,0.666667,0.75,0,5,0,0.020692
117021402,117021402,,0,1,1,0,1,1,8,0.303216,0.342457,0,9,0,0.00479
2857247126,2857247126,,0,4,4,0,4,4,7,0.33413,0.369888,0,9,0,0.009918
1018935842268688384,1018935842268688384,,0,0,0,0,0,0,0,0,0,0,205,0,0
725386410358878208,725386410358878208,,0,2,2,0,2,2,8,0.303546,0.34345,0,9,0,0.025483
1388570703553777664,1388570703553777664,,0,1,1,0,1,1,2,0.666667,0.75,0,37,0,0
931948634190598144,931948634190598144,,2,1,3,2,1,3,1,1,1,0,37,0,0.003445
769873757460656128,769873757460656128,,0,1,1,0,1,1,2,0.666667,0.75,0,5,0,0.020692
1273298206357585920,1273298206357585920,,2,0,2,2,0,2,0,0,0,0,18,0.000145,0
1289249050991169536,1289249050991169536,,0,1,1,0,1,1,2,0.666667,0.75,0,5,0,0.020692
2239716348,2239716348,,0,1,1,0,1,1,2,0.666667,0.75,0,13,0,0.017924
33284443,33284443,,1,4,5,2,5,7,2,0.7,0.785714,0,206,0.000791,0.038683
899254099161559040,899254099161559040,,0,2,2,0,2,2,2,0.75,0.833333,0,57,0,0.020727
1057735056175841280,1057735056175841280,,0,6,6,0,6,6,7,0.287953,0.314464,0,5,0,0.027523
1419770178104070144,1419770178104070144,,0,1,1,0,1,1,2,0.666667,0.75,0,37,0,0
495011205,495011205,,1,1,2,2,1,3,1,1,1,0.000006,13,0,0
1450173055578296320,1450173055578296320,,0,1,1,0,1,1,2,0.666667,0.75,0,5,0,0.020692
132237488,132237488,,0,2,2,0,2,2,7,0.272727,0.306162,0,14,0,0.022827
489519253,489519253,,0,1,1,0,1,1,7,0.272226,0.304285,0,14,0,0.002135
1367491115662913536,1367491115662913536,,0,1,1,0,1,1,2,0.666667,0.75,0,5,0,0.020692
3243517432,3243517432,,0,2,2,0,2,2,7,0.328891,0.372657,0,14,0,0.006925
2415662937,2415662937,,0,2,2,0,2,2,8,0.303546,0.34345,0,9,0,0.025483
901458763261104128,901458763261104128,,0,1,1,0,1,1,2,0.666667,0.75,0,5,0,0.020692
1351098318957514752,1351098318957514752,,0,1,1,0,1,1,2,0.666667,0.75,0,5,0,0.020692
1159610345637457920,1159610345637457920,,0,1,1,0,1,1,2,0.666667,0.75,0,13,0,0.017924
1340983773870043136,1340983773870043136,,0,1,1,0,1,1,2,0.666667,0.75,0,5,0,0.020692
1304503355356708864,1304503355356708864,,1,2,3,1,2,3,3,0.533333,0.604167,0.000011,28,0.000002,0.000018
2200349455,2200349455,,0,1,1,0,1,1,7,0.283203,0.300698,0,9,0,0.004809
336592522,336592522,,0,1,1,0,1,1,2,0.666667,0.75,0,5,0,0.020692
827252208148312064,827252208148312064,,0,2,2,0,2,2,2,0.666667,0.75,0,5,0,0.038617
14561296,14561296,,0,3,3,0,3,3,6,0.380463,0.422523,0,14,0,0.009729
1266040674840981504,1266040674840981504,,0,1,1,0,1,1,2,0.666667,0.75,0,5,0,0.020692
1424418502417555456,1424418502417555456,,0,1,1,0,1,1,2,0.666667,0.75,0,5,0,0.020692
1445102746718322688,1445102746718322688,,0,1,1,0,1,1,7,0.283203,0.300698,0,9,0,0.004809
260376774,260376774,,0,3,3,0,3,3,6,0.392857,0.434382,0,21,0,0.025708
439487431,439487431,,0,1,1,0,1,1,8,0.303216,0.342457,0,9,0,0.00479
421777059,421777059,,0,2,2,0,2,2,8,0.303546,0.34345,0,9,0,0.025483
1088144288347770880,1088144288347770880,,0,1,1,0,1,1,8,0.303216,0.342457,0,9,0,0.00479
561569814,561569814,,0,2,2,0,2,2,2,0.555556,0.6,0,15,0,0.02104
1379956645,1379956645,,0,2,2,0,2,2,8,0.303546,0.34345,0,9,0,0.025483
1213193293439229952,1213193293439229952,,0,1,1,0,1,1,8,0.303216,0.342457,0,9,0,0.00479
1440011033398099968,1440011033398099968,,0,1,1,0,1,1,2,0.666667,0.75,0,13,0,0.017924
110654085,110654085,,0,3,3,0,3,3,8,0.303655,0.344046,0,37,0,0.028928
352642644,352642644,,0,1,1,0,1,1,1,1,1,0,207,0,0
19028516,19028516,,2,0,2,2,0,2,0,0,0,0,207,0,0
1432823832675553280,1432823832675553280,,0,1,1,0,1,1,2,0.666667,0.75,0,5,0,0.020692
1407566336,1407566336,,0,1,1,0,1,1,8,0.303216,0.342457,0,9,0,0.00479
18078888,18078888,,0,1,1,0,1,1,8,0.303216,0.342457,0,9,0,0.00479
225742736,225742736,,0,1,1,0,1,1,2,0.666667,0.75,0,5,0,0.020692
1456331970,1456331970,,0,1,1,0,1,1,2,0.666667,0.75,0,5,0,0.020692
436610728,436610728,,0,4,4,0,5,5,8,0.304049,0.345012,0,206,0,0.02553
1098986690981621760,1098986690981621760,,2,0,2,4,0,4,0,0,0,0,206,0.000746,0
1095281650215383040,1095281650215383040,,0,1,1,0,1,1,2,0.666667,0.75,0,5,0,0.020692
1056421320,1056421320,,0,1,1,0,1,1,2,0.666667,0.75,0,5,0,0.020692
240451626,240451626,,0,4,4,0,6,6,6,0.320809,0.350601,0,14,0,0.029149
35184097,35184097,,0,1,1,0,1,1,2,0.666667,0.75,0,5,0,0.020692
2391748286,2391748286,,0,1,1,0,1,1,7,0.283203,0.300698,0,9,0,0.004809
1291816134006714368,1291816134006714368,,0,1,1,0,1,1,7,0.272226,0.304285,0,14,0,0.002135
1087951886781726720,1087951886781726720,,0,1,1,0,2,2,2,0.666667,0.75,0,13,0,0.017924
1009679684152512512,1009679684152512512,,0,1,1,0,1,1,7,0.283203,0.300698,0,9,0,0.004809
1181288004108861440,1181288004108861440,,0,1,1,0,1,1,2,0.666667,0.75,0,5,0,0.020692
1251474762460790784,1251474762460790784,,0,3,3,0,3,3,8,0.303986,0.344404,0,15,0,0.025778
220966596,220966596,,0,1,1,0,1,1,1,1,1,0,9,0,0.000612
307541960,307541960,,0,1,1,0,1,1,2,0.666667,0.75,0,5,0,0.020692
1435555389135859712,1435555389135859712,,0,1,1,0,1,1,2,0.666667,0.75,0,5,0,0.020692
1171047351642972160,1171047351642972160,,0,2,2,0,2,2,7,0.272895,0.306349,0,14,0,0.020059
2601249995,2601249995,,0,1,1,0,1,1,2,0.666667,0.75,0,5,0,0.020692
215735286,215735286,,0,1,1,0,1,1,2,0.666667,0.75,0,13,0,0.017924
1191558961,1191558961,,0,2,2,0,2,2,6,0.391781,0.432051,0,9,0,0.024842
914569146993664000,914569146993664000,,0,1,1,0,1,1,2,0.666667,0.75,0,5,0,0.020692
1358804287095271424,1358804287095271424,,0,1,1,0,1,1,2,0.666667,0.75,0,5,0,0.020692
713152462107095040,713152462107095040,,0,2,2,0,2,2,8,0.303546,0.34345,0,9,0,0.025483
1450146410926649344,1450146410926649344,,0,1,1,0,1,1,2,0.666667,0.75,0,5,0,0.020692
2978930992,2978930992,,0,1,1,0,1,1,2,0.666667,0.75,0,5,0,0.020692
879812316291903488,879812316291903488,,0,4,4,0,4,4,6,0.377928,0.419925,0,9,0,0.028455
4038038116,4038038116,,0,5,5,0,6,6,6,0.34769,0.380405,0,13,0,0.04715
1407830436945014784,1407830436945014784,,0,4,4,0,4,4,8,0.303875,0.344841,0,5,0,0.025658
1368605852610002944,1368605852610002944,,0,2,2,0,2,2,7,0.283757,0.302997,0,9,0,0.022733
1113435757178445824,1113435757178445824,,0,1,1,0,1,1,2,0.666667,0.75,0,5,0,0.020692
1183381612635086848,1183381612635086848,,0,2,2,0,2,2,2,0.75,0.833333,0,15,0,0.022161
2261604322,2261604322,,0,2,2,0,2,2,4,0.454545,0.541667,0,15,0,0.021124
1448742124283912192,1448742124283912192,,0,1,1,0,1,1,2,0.666667,0.75,0,5,0,0.020692
1315395996,1315395996,,0,2,2,0,2,2,7,0.27256,0.305786,0,37,0,0.005579
1439877217077633024,1439877217077633024,,0,1,1,0,1,1,7,0.283203,0.300698,0,9,0,0.004809
1310677834373967872,1310677834373967872,,0,1,1,0,1,1,2,0.666667,0.75,0,5,0,0.020692
4867636829,4867636829,,0,4,4,0,6,6,6,0.416052,0.450443,0,15,0,0.008222
1015955288023797760,1015955288023797760,,0,1,1,0,1,1,2,0.666667,0.75,0,5,0,0.020692
1072804853531983872,1072804853531983872,,0,0,0,0,0,0,0,0,0,0,208,0,0
2306567981,2306567981,,0,2,2,0,2,2,8,0.303546,0.34345,0,9,0,0.025483
601062168,601062168,,0,1,1,0,1,1,2,0.555556,0.6,0,14,0,0.000084
1445435850226077696,1445435850226077696,,0,1,1,0,1,1,2,0.666667,0.75,0,13,0,0.017924
1152706754888773632,1152706754888773632,,0,1,1,0,1,1,2,0.666667,0.75,0,5,0,0.020692
1224799310564425728,1224799310564425728,,0,1,1,0,1,1,8,0.303216,0.342457,0,9,0,0.00479
1349750372039065600,1349750372039065600,,0,1,1,0,1,1,2,0.666667,0.75,0,5,0,0.020692
1202232975930396672,1202232975930396672,,0,1,1,0,1,1,2,0.666667,0.75,0,5,0,0.020692
40433343,40433343,,0,1,1,0,1,1,2,0.666667,0.75,0,5,0,0.020692
2241594340,2241594340,,0,3,3,0,3,3,8,0.303986,0.344543,0,21,0,0.023663
1247778896956624896,1247778896956624896,,0,2,2,0,2,2,1,1,1,0,37,0,0.024137
1382758068686053376,1382758068686053376,,0,1,1,0,1,1,2,0.666667,0.75,0,5,0,0.020692
919417542,919417542,,0,2,2,0,2,2,2,0.666667,0.75,0,5,0,0.038617
1339706288733900800,1339706288733900800,,0,2,2,0,2,2,2,0.666667,0.75,0,5,0,0.038617
1027404487,1027404487,,0,2,2,0,2,2,7,0.286561,0.306388,0,57,0,0.005054
525587066,525587066,,0,3,3,0,3,3,6,0.392422,0.433563,0,9,0,0.026883
919526072,919526072,,2,0,2,2,0,2,0,0,0,0,14,0.002117,0
1351302086986784768,1351302086986784768,,0,1,1,0,1,1,2,0.666667,0.75,0,5,0,0.020692
1163031534565285888,1163031534565285888,,0,3,3,0,3,3,6,0.392422,0.433563,0,9,0,0.026883
1045683818773041152,1045683818773041152,,0,2,2,0,2,2,1,1,1,0,9,0,0.002081
1280820105828544512,1280820105828544512,,0,1,1,0,1,1,2,0.666667,0.75,0,13,0,0.017924
3004247111,3004247111,,0,2,2,0,2,2,2,0.75,0.833333,0,37,0,0.021369
1303641577294888960,1303641577294888960,,0,1,1,0,1,1,2,0.666667,0.75,0,13,0,0.017924
986811270,986811270,,0,1,1,0,1,1,2,0.666667,0.75,0,13,0,0.017924
490504673,490504673,,0,1,1,0,1,1,2,0.666667,0.75,0,5,0,0.020692
433664513,433664513,,0,3,3,0,3,3,7,0.329278,0.373651,0,14,0,0.027618
1363957089425649664,1363957089425649664,,0,3,3,0,3,3,6,0.392422,0.433563,0,9,0,0.026883
1214466915634237440,1214466915634237440,,0,1,1,0,1,1,2,0.666667,0.75,0,5,0,0.020692
1266649207,1266649207,,0,3,3,0,3,3,6,0.362106,0.405463,0,9,0,0.013749
442263663,442263663,,0,1,1,0,1,1,2,0.666667,0.75,0,5,0,0.020692
1233552234618785792,1233552234618785792,,0,1,1,0,1,1,2,0.666667,0.75,0,5,0,0.020692
1208755185679511552,1208755185679511552,,0,1,1,0,1,1,2,0.666667,0.75,0,5,0,0.020692
3637,3637,,0,2,2,0,2,2,3,0.514286,0.546296,0,28,0,0.000001
889057141,889057141,,0,1,1,0,1,1,2,0.666667,0.75,0,5,0,0.020692
244108172,244108172,,0,1,1,0,1,1,2,0.666667,0.75,0,5,0,0.020692
408544727,408544727,,0,2,2,0,2,2,6,0.391484,0.431813,0,9,0,0.022074
359096965,359096965,,0,1,1,0,1,1,3,0.5,0.566667,0,13,0,0
4853628435,4853628435,,1,3,4,1,4,5,2,0.8,0.875,0,13,0,0.017955
1004719615,1004719615,,0,0,0,0,0,0,0,0,0,0,209,0,0
1037588599,1037588599,,0,1,1,0,1,1,2,0.666667,0.75,0,5,0,0.020692
1406889570797555712,1406889570797555712,,0,4,4,0,4,4,6,0.393343,0.432718,0,14,0,0.031768
40004536,40004536,,0,1,1,0,1,1,2,0.666667,0.75,0,5,0,0.020692
129294266,129294266,,0,2,2,0,2,2,7,0.305755,0.334223,0,9,0,0.006399
1372972843965812736,1372972843965812736,,0,4,4,0,4,4,6,0.362576,0.406456,0,9,0,0.034441
1232199919391444992,1232199919391444992,,0,1,1,0,1,1,2,0.666667,0.75,0,5,0,0.020692
302484971,302484971,,0,2,2,0,2,2,2,0.75,0.833333,0,13,0,0.01799
464822421,464822421,,0,2,2,0,3,3,6,0.379812,0.421021,0,14,0,0.006285
1162465580265484288,1162465580265484288,,0,1,1,0,1,1,8,0.303216,0.342457,0,9,0,0.00479
491461681,491461681,,0,1,1,0,1,1,2,0.666667,0.75,0,5,0,0.020692
1353334005605785600,1353334005605785600,,0,1,1,0,1,1,7,0.283203,0.300698,0,9,0,0.004809
1418889033174896640,1418889033174896640,,0,1,1,0,1,1,2,0.666667,0.75,0,5,0,0.020692
1147914297969954816,1147914297969954816,,0,1,1,0,1,1,2,0.666667,0.75,0,5,0,0.020692
319537863,319537863,,0,1,1,0,1,1,2,0.666667,0.75,0,5,0,0.020692
1006081105567670272,1006081105567670272,,0,5,5,0,6,6,6,0.363008,0.407361,0,15,0,0.02986
1325851962756263936,1325851962756263936,,1,0,1,2,0,2,0,0,0,0,15,0.000872,0
2415181569,2415181569,,0,1,1,0,1,1,2,0.666667,0.75,0,5,0,0.020692
899660611629535232,899660611629535232,,1,0,1,2,0,2,0,0,0,0,13,0.000524,0
1480756566,1480756566,,1,0,1,1,0,1,0,0,0,0,13,0.000524,0
784109636005814272,784109636005814272,,0,1,1,0,1,1,2,0.666667,0.75,0,5,0,0.020692
1138570155070545920,1138570155070545920,,0,1,1,0,1,1,8,0.303216,0.342457,0,9,0,0.00479
1445312025241034752,1445312025241034752,,0,2,2,0,2,2,1,1,1,0,18,0,0.001034
1348970029036023808,1348970029036023808,,0,1,1,0,1,1,2,0.666667,0.75,0,5,0,0.020692
631242056,631242056,,0,2,2,0,2,2,7,0.284457,0.30396,0,9,0,0.025501
152006671,152006671,,0,2,2,0,2,2,8,0.303546,0.34345,0,9,0,0.025483
1226896707776106496,1226896707776106496,,0,1,1,0,1,1,8,0.303216,0.342457,0,9,0,0.00479
1131927937354207232,1131927937354207232,,0,1,1,0,1,1,3,0.5,0.611111,0,13,0,0.000018
475994227,475994227,,0,0,0,0,0,0,0,0,0,0,210,0,0
1361665772465102848,1361665772465102848,,0,1,1,0,1,1,2,0.666667,0.75,0,5,0,0.020692
958029507167969280,958029507167969280,,0,1,1,0,1,1,2,0.666667,0.75,0,5,0,0.020692
22360944,22360944,,0,1,1,0,1,1,2,0.666667,0.75,0,5,0,0.020692
4480481955,4480481955,,0,1,1,0,1,1,2,0.666667,0.75,0,5,0,0.020692
365076749,365076749,,0,2,2,0,2,2,7,0.330185,0.364425,0,9,0,0.009599
3026367370,3026367370,,0,3,3,0,4,4,2,0.8,0.875,0,5,0,0.020728
313457842,313457842,,1,0,1,2,0,2,0,0,0,0,5,0.000605,0
1447454598252400640,1447454598252400640,,1,0,1,1,0,1,0,0,0,0,5,0.000605,0
710554164770816000,710554164770816000,,1,2,3,1,2,3,5,0.43125,0.465459,0.000016,37,0.00021,0.005035
3386953695,3386953695,,1,1,2,1,1,2,2,0.666667,0.75,0,9,0.00021,0.017924
1335927252526256128,1335927252526256128,,1,0,1,1,0,1,0,0,0,0,9,0.00021,0
568477510,568477510,,1,0,1,1,0,1,0,0,0,0,9,0.00021,0
321264725,321264725,,1,0,1,1,0,1,0,0,0,0,9,0.00021,0
2353672568,2353672568,,1,0,1,1,0,1,0,0,0,0,9,0.00021,0
328702580,328702580,,1,1,2,1,1,2,2,0.666667,0.75,0,9,0.00021,0.020692
1961048316,1961048316,,1,0,1,1,0,1,0,0,0,0,9,0.00021,0
1382940695846121472,1382940695846121472,,1,1,2,1,1,2,2,0.666667,0.75,0,9,0.00021,0.020692
498006308,498006308,,1,1,2,1,1,2,2,0.666667,0.75,0,9,0.00021,0.020692
1433735493150257152,1433735493150257152,,1,1,2,1,1,2,1,1,1,0.000004,13,0.00021,0.000102
1081200388945178624,1081200388945178624,,1,1,2,1,1,2,1,1,1,0,37,0.00021,0.003445
1487987467,1487987467,,1,0,1,1,0,1,0,0,0,0,9,0.00021,0
1701836234,1701836234,,1,4,5,1,4,5,6,0.393531,0.435731,0.000016,5,0.00021,0.029896
1022046809437491200,1022046809437491200,,1,0,1,1,0,1,0,0,0,0,9,0.00021,0
75668545,75668545,,1,0,1,1,0,1,0,0,0,0,9,0.00021,0
1073150476223430656,1073150476223430656,,1,0,1,1,0,1,0,0,0,0,9,0.00021,0
4047552142,4047552142,,1,1,2,1,1,2,2,0.666667,0.75,0,9,0.00021,0.020692
585763292,585763292,,1,3,4,1,3,4,6,0.421829,0.456235,0.000036,14,0.00021,0.025844
1346017812301701120,1346017812301701120,,1,0,1,1,0,1,0,0,0,0,9,0.00021,0
460987353,460987353,,1,3,4,1,3,4,5,0.444444,0.478509,0.00003,15,0.00021,0.019862
1419805096184057856,1419805096184057856,,1,3,4,1,3,4,6,0.392422,0.433563,0.000012,9,0.00021,0.026883
1037678352,1037678352,,1,1,2,1,1,2,6,0.390411,0.429474,0.000012,9,0.00021,0.00415
2216232324,2216232324,,1,1,2,1,1,2,2,0.666667,0.75,0,9,0.00021,0.020692
1138556306846101504,1138556306846101504,,2,0,2,2,0,2,0,0,0,0,14,0.000218,0
1321043018414260224,1321043018414260224,,1,0,1,1,0,1,0,0,0,0,9,0.00021,0
1361012416201555968,1361012416201555968,,1,0,1,1,0,1,0,0,0,0,9,0.00021,0
1085979823,1085979823,,1,1,2,1,1,2,4,0.421053,0.489583,0.000007,15,0.00021,0.000431
125488839,125488839,,1,1,2,1,1,2,6,0.390411,0.429474,0.000012,9,0.00021,0.00415
440247035,440247035,,1,2,3,1,2,3,4,0.417722,0.462121,0.00004,57,0.00021,0.000616
109027544,109027544,,1,2,3,1,2,3,2,0.75,0.833333,0.000004,37,0.00021,0.018029
1019503295143071744,1019503295143071744,,1,0,1,1,0,1,0,0,0,0,9,0.00021,0
2906219769,2906219769,,1,0,1,1,0,1,0,0,0,0,9,0.00021,0
3090115451,3090115451,,1,0,1,1,0,1,0,0,0,0,9,0.00021,0
2225786343,2225786343,,1,0,1,1,0,1,0,0,0,0,9,0.00021,0
2217521461,2217521461,,1,0,1,1,0,1,0,0,0,0,9,0.00021,0
167014241,167014241,,1,0,1,1,0,1,0,0,0,0,9,0.00021,0
761165912,761165912,,1,0,1,1,0,1,0,0,0,0,9,0.00021,0
1281535346749181952,1281535346749181952,,1,2,3,1,2,3,2,0.75,0.833333,0.000008,14,0.00021,0.01794
366669932,366669932,,1,0,1,1,0,1,0,0,0,0,9,0.00021,0
2743258907,2743258907,,1,0,1,1,0,1,0,0,0,0,9,0.00021,0
821810033713364992,821810033713364992,,1,0,1,1,0,1,0,0,0,0,9,0.00021,0
1438035815477751808,1438035815477751808,,1,0,1,1,0,1,0,0,0,0,9,0.00021,0
2272008636,2272008636,,1,0,1,1,0,1,0,0,0,0,9,0.00021,0
876461518342283264,876461518342283264,,1,1,2,1,1,2,7,0.272226,0.304285,0.000037,14,0.00021,0.002135
111886145,111886145,,1,1,2,1,1,2,2,0.666667,0.75,0,9,0.00021,0.017924
397123362,397123362,,1,1,2,1,1,2,2,0.666667,0.75,0,9,0.00021,0.020692
898297518,898297518,,1,2,3,1,2,3,6,0.391245,0.431469,0.000021,15,0.00021,0.004155
1675339604,1675339604,,1,0,1,1,0,1,0,0,0,0,9,0.00021,0
1672667984,1672667984,,1,0,1,1,0,1,0,0,0,0,9,0.00021,0
447030594,447030594,,1,1,2,1,1,2,6,0.390411,0.429474,0.000012,9,0.00021,0.00415
2179859282,2179859282,,1,0,1,1,0,1,0,0,0,0,9,0.00021,0
2489756778,2489756778,,1,3,4,1,3,4,7,0.272895,0.307288,0.000038,14,0.00021,0.026272
1350881020959203328,1350881020959203328,,1,1,2,1,1,2,1,1,1,0.000001,14,0.00021,0.001513
942103122742272000,942103122742272000,,1,1,2,1,1,2,7,0.283203,0.300698,0,9,0.00021,0.004809
3092536996,3092536996,,1,2,3,1,2,3,4,0.483871,0.513889,0.000025,14,0.00021,0.001622
1450064250806972416,1450064250806972416,,1,0,1,1,0,1,0,0,0,0,9,0.00021,0
1206356976,1206356976,,1,0,1,1,0,1,0,0,0,0,9,0.00021,0
483865095,483865095,,1,1,2,1,1,2,1,1,1,0,37,0.00021,0.003445
522229636,522229636,,1,1,2,1,1,2,7,0.283203,0.300698,0,9,0.00021,0.004809
464967619,464967619,,1,0,1,1,0,1,0,0,0,0,9,0.00021,0
3037643774,3037643774,,1,0,1,1,0,1,0,0,0,0,9,0.00021,0
1439545402542497792,1439545402542497792,,1,1,2,1,1,2,2,0.666667,0.75,0,9,0.00021,0.017924
1431307264720310272,1431307264720310272,,1,1,2,1,1,2,1,1,1,0,15,0.00021,0.001469
1153676843108712448,1153676843108712448,,1,2,3,1,2,3,7,0.283757,0.302997,0,9,0.00021,0.022733
2968494345,2968494345,,1,0,1,1,0,1,0,0,0,0,9,0.00021,0
1442876232102600704,1442876232102600704,,1,0,1,1,0,1,0,0,0,0,9,0.00021,0
4889385693,4889385693,,1,1,2,1,1,2,7,0.283203,0.300698,0,9,0.00021,0.004809
75983324,75983324,,1,0,1,1,0,1,0,0,0,0,9,0.00021,0
333098917,333098917,,1,0,1,1,0,1,0,0,0,0,9,0.00021,0
401293035,401293035,,1,0,1,1,0,1,0,0,0,0,9,0.00021,0
1426605221300555776,1426605221300555776,,1,0,1,1,0,1,0,0,0,0,9,0.00021,0
1268998861101596672,1268998861101596672,,1,0,1,1,0,1,0,0,0,0,9,0.00021,0
554226518,554226518,,1,1,2,1,2,3,2,0.666667,0.75,0,13,0.00021,0.017924
1419748003305361408,1419748003305361408,,1,0,1,1,0,1,0,0,0,0,9,0.00021,0
1334666292,1334666292,,1,0,1,1,0,1,0,0,0,0,9,0.00021,0
2887988230,2887988230,,1,2,3,1,3,4,2,0.75,0.833333,0,13,0.00021,0.019393
1923305407,1923305407,,1,1,2,1,1,2,6,0.390411,0.429474,0.000012,9,0.00021,0.00415
1103812855,1103812855,,1,1,2,1,2,3,1,1,1,0.000009,9,0.00021,0.000017
1327391973607608320,1327391973607608320,,1,0,1,1,0,1,0,0,0,0,9,0.00021,0
3303785681,3303785681,,1,1,2,1,1,2,7,0.283203,0.300698,0,9,0.00021,0.004809
501783959,501783959,,1,0,1,1,0,1,0,0,0,0,9,0.00021,0
2387022703,2387022703,,1,0,1,1,0,1,0,0,0,0,9,0.00021,0
1032653803575828480,1032653803575828480,,1,0,1,1,0,1,0,0,0,0,9,0.00021,0
1069263193,1069263193,,2,1,3,2,1,3,3,0.444444,0.5,0.000008,18,0.000355,0.000308
1528903098,1528903098,,1,1,2,1,1,2,6,0.390411,0.429474,0.000012,9,0.00021,0.00415
1266769243,1266769243,,1,0,1,1,0,1,0,0,0,0,9,0.00021,0
2845206706,2845206706,,1,0,1,1,0,1,0,0,0,0,9,0.00021,0
1388469527692943360,1388469527692943360,,1,2,3,1,2,3,1,1,1,0.000001,15,0.00021,0.002982
1623373956,1623373956,,1,4,5,1,4,5,2,0.75,0.833333,0.000014,15,0.00021,0.022351
1440698566058524672,1440698566058524672,,1,0,1,1,0,1,0,0,0,0,9,0.00021,0
4053637276,4053637276,,1,1,2,1,1,2,1,1,1,0,37,0.00021,0.003445
555481994,555481994,,1,0,1,1,0,1,0,0,0,0,9,0.00021,0
1651052388,1651052388,,1,0,1,1,0,1,0,0,0,0,9,0.00021,0
1187380629085790208,1187380629085790208,,1,3,4,1,4,5,6,0.392422,0.433563,0.000012,13,0.00021,0.026883
1088748639349100544,1088748639349100544,,1,6,7,1,6,7,7,0.295093,0.341878,0.000061,9,0.00021,0.024596
725968843563225088,725968843563225088,,1,1,2,1,1,2,2,0.666667,0.75,0.000012,18,0.00021,0.000097
452002657,452002657,,1,0,1,1,0,1,0,0,0,0,9,0.00021,0
433556267,433556267,,1,0,1,1,0,1,0,0,0,0,9,0.00021,0
1585400108,1585400108,,1,3,4,1,3,4,6,0.402613,0.441544,0.000037,9,0.00021,0.005806
283188007,283188007,,1,0,1,1,0,1,0,0,0,0,9,0.00021,0
627317336,627317336,,1,0,1,1,0,1,0,0,0,0,9,0.00021,0
563261187,563261187,,1,1,2,1,1,2,1,1,1,0.000004,37,0.00021,0.000105
470242115,470242115,,1,2,3,1,2,3,7,0.284035,0.303284,0.000001,25,0.00021,0.005429
2969868167,2969868167,,1,0,1,1,0,1,0,0,0,0,9,0.00021,0
529696469,529696469,,1,0,1,1,0,1,0,0,0,0,9,0.00021,0
1395576606,1395576606,,1,1,2,1,1,2,6,0.390411,0.429474,0.000012,9,0.00021,0.00415
2354704705,2354704705,,1,3,4,1,3,4,6,0.392613,0.43403,0.000021,5,0.00021,0.025079
733371062902239232,733371062902239232,,1,0,1,1,0,1,0,0,0,0,9,0.00021,0
427610792,427610792,,1,1,2,1,1,2,1,1,1,0,15,0.00021,0.001469
431172304,431172304,,1,1,2,1,1,2,2,0.666667,0.75,0,9,0.00021,0.017924
117067060,117067060,,1,0,1,1,0,1,0,0,0,0,9,0.00021,0
1327518346586296320,1327518346586296320,,1,2,3,1,2,3,6,0.391484,0.431813,0.000016,9,0.00021,0.004458
1397862633106251776,1397862633106251776,,1,1,2,1,1,2,2,0.666667,0.75,0,9,0.00021,0.020692
4033699635,4033699635,,1,0,1,1,0,1,0,0,0,0,9,0.00021,0
1435369757969092608,1435369757969092608,,1,1,2,1,1,2,2,0.666667,0.75,0,9,0.00021,0.020692
1428401488079073280,1428401488079073280,,1,0,1,1,0,1,0,0,0,0,9,0.00021,0
4557625767,4557625767,,1,0,1,1,0,1,0,0,0,0,9,0.00021,0
1341063070983008256,1341063070983008256,,1,0,1,1,0,1,0,0,0,0,9,0.00021,0
1344371068518211584,1344371068518211584,,1,1,2,1,1,2,6,0.390411,0.429474,0.000012,9,0.00021,0.00415
584493587,584493587,,1,1,2,1,1,2,2,0.666667,0.75,0,9,0.00021,0.020692
526710455,526710455,,2,3,5,2,3,5,4,0.47619,0.591667,0.000025,15,0.000218,0.000617
175740559,175740559,,1,0,1,1,0,1,0,0,0,0,9,0.00021,0
1420345547970465792,1420345547970465792,,1,0,1,1,0,1,0,0,0,0,9,0.00021,0
3342580425,3342580425,,1,1,2,1,1,2,5,0.425926,0.455797,0.000016,15,0.00021,0.00159
1447984057330118656,1447984057330118656,,1,0,1,1,0,1,0,0,0,0,9,0.00021,0
168976630,168976630,,1,2,3,1,2,3,6,0.391363,0.431264,0.000012,9,0.00021,0.008958
872116496373338112,872116496373338112,,1,0,1,1,0,1,0,0,0,0,9,0.00021,0
1437072653215485952,1437072653215485952,,1,0,1,1,0,1,0,0,0,0,9,0.00021,0
1418509280710467584,1418509280710467584,,1,2,3,1,2,3,6,0.391363,0.431264,0.000012,9,0.00021,0.008958
1019368217024909312,1019368217024909312,,1,0,1,1,0,1,0,0,0,0,9,0.00021,0
305131113,305131113,,1,0,1,1,0,1,0,0,0,0,9,0.00021,0
1167040358330642432,1167040358330642432,,1,0,1,1,0,1,0,0,0,0,9,0.00021,0
973585408255823872,973585408255823872,,1,1,2,1,1,2,4,0.421053,0.489583,0.000007,15,0.00021,0.000431
1416709768090030080,1416709768090030080,,1,1,2,1,1,2,6,0.390411,0.429474,0.000012,9,0.00021,0.00415
769523242046525440,769523242046525440,,1,0,1,1,0,1,0,0,0,0,9,0.00021,0
2200290805,2200290805,,1,1,2,1,1,2,6,0.390411,0.429474,0.000012,9,0.00021,0.00415
33859210,33859210,,1,1,2,1,1,2,2,0.666667,0.75,0,9,0.00021,0.017924
1384189275722293248,1384189275722293248,,1,1,2,1,1,2,6,0.390411,0.429474,0.000012,9,0.00021,0.00415
1032521732962299904,1032521732962299904,,1,0,1,1,0,1,0,0,0,0,9,0.00021,0
482033828,482033828,,1,0,1,1,0,1,0,0,0,0,9,0.00021,0
859500037981835264,859500037981835264,,1,0,1,1,0,1,0,0,0,0,9,0.00021,0
1416080717428269056,1416080717428269056,,1,2,3,1,2,3,4,0.416667,0.463889,0.000022,25,0.00021,0.021063
885363481431638016,885363481431638016,,1,2,3,1,3,4,5,0.43125,0.465459,0.000016,15,0.00021,0.005035
1162441321598128128,1162441321598128128,,1,0,1,1,0,1,0,0,0,0,9,0.00021,0
540845601,540845601,,1,0,1,1,0,1,0,0,0,0,9,0.00021,0
1647633728,1647633728,,1,0,1,1,0,1,0,0,0,0,9,0.00021,0
312691936,312691936,,1,2,3,1,2,3,2,0.666667,0.75,0,9,0.00021,0.038617
192144957,192144957,,1,0,1,1,0,1,0,0,0,0,9,0.00021,0
2273094851,2273094851,,1,1,2,1,2,3,2,0.666667,0.75,0,13,0.00021,0.017924
341099952,341099952,,1,0,1,1,0,1,0,0,0,0,9,0.00021,0
978197286076510208,978197286076510208,,1,2,3,1,2,3,7,0.283902,0.303101,0.000001,9,0.00021,0.005751
1378701952163405824,1378701952163405824,,1,0,1,1,0,1,0,0,0,0,9,0.00021,0
2849566250,2849566250,,1,0,1,1,0,1,0,0,0,0,9,0.00021,0
1307382828,1307382828,,1,1,2,1,1,2,2,0.666667,0.75,0,9,0.00021,0.017924
811209223715639296,811209223715639296,,1,2,3,1,2,3,7,0.284035,0.303284,0.000001,21,0.00021,0.005674
4896258532,4896258532,,1,1,2,1,1,2,6,0.28169,0.320417,0.000021,15,0.00021,0.000083
968582010,968582010,,1,3,4,1,3,4,7,0.307856,0.33202,0.000024,14,0.00021,0.009255
1055892264780787712,1055892264780787712,,1,0,1,1,0,1,0,0,0,0,9,0.00021,0
1157781200,1157781200,,1,0,1,1,0,1,0,0,0,0,9,0.00021,0
2525213951,2525213951,,1,0,1,1,0,1,0,0,0,0,9,0.00021,0
984564349,984564349,,1,0,1,1,0,1,0,0,0,0,9,0.00021,0
1418920748329099264,1418920748329099264,,1,0,1,1,0,1,0,0,0,0,9,0.00021,0
1235621897796280320,1235621897796280320,,1,2,3,1,2,3,6,0.391363,0.431264,0.000012,9,0.00021,0.008958
1385929787936583680,1385929787936583680,,1,0,1,1,0,1,0,0,0,0,9,0.00021,0
745351426117869568,745351426117869568,,1,3,4,1,3,4,2,0.8,0.875,0.000003,21,0.00021,0.019508
487524602,487524602,,1,0,1,1,0,1,0,0,0,0,9,0.00021,0
437734783,437734783,,1,1,2,1,1,2,5,0.425926,0.455797,0.000016,15,0.00021,0.00159
1377366188045565952,1377366188045565952,,1,0,1,1,0,1,0,0,0,0,9,0.00021,0
1408013482512072704,1408013482512072704,,1,0,1,1,0,1,0,0,0,0,9,0.00021,0
1022498369707671552,1022498369707671552,,1,0,1,1,0,1,0,0,0,0,9,0.00021,0
896829755298914304,896829755298914304,,1,1,2,1,1,2,2,0.666667,0.75,0,9,0.00021,0.020692
940519346610335744,940519346610335744,,1,0,1,1,0,1,0,0,0,0,9,0.00021,0
957740399283589120,957740399283589120,,1,0,1,1,0,1,0,0,0,0,9,0.00021,0
807513044,807513044,,1,2,3,1,2,3,7,0.283757,0.302997,0,9,0.00021,0.022733
1354478231613804544,1354478231613804544,,1,4,5,1,4,5,6,0.421739,0.456987,0.000046,17,0.00021,0.009969
433718217,433718217,,1,1,2,1,1,2,2,0.666667,0.75,0,9,0.00021,0.020692
1086691638,1086691638,,1,1,2,1,1,2,6,0.390411,0.429474,0.000012,9,0.00021,0.00415
1439839925944340480,1439839925944340480,,1,3,4,1,3,4,6,0.383089,0.424249,0.000049,14,0.00021,0.011093
914604396,914604396,,1,0,1,1,0,1,0,0,0,0,9,0.00021,0
1424014391712829440,1424014391712829440,,1,3,4,1,6,7,3,0.555556,0.633333,0.000062,9,0.00021,0.000035
1428619804299210752,1428619804299210752,,1,1,2,1,1,2,6,0.390411,0.429474,0.000012,9,0.00021,0.00415
190995794,190995794,,1,0,1,1,0,1,0,0,0,0,9,0.00021,0
1408039806697881600,1408039806697881600,,1,0,1,1,0,1,0,0,0,0,9,0.00021,0
1441806873796116480,1441806873796116480,,1,2,3,1,2,3,6,0.391484,0.431813,0.000012,9,0.00021,0.022074
942438985766461440,942438985766461440,,1,2,3,1,3,4,6,0.391484,0.431813,0.000012,13,0.00021,0.022074
895328666565128192,895328666565128192,,1,0,1,1,0,1,0,0,0,0,9,0.00021,0
1620754188,1620754188,,1,3,4,1,3,4,2,0.714286,0.8,0.000008,5,0.00021,0.038679
785593381103636480,785593381103636480,,1,2,3,1,2,3,7,0.284035,0.303284,0,37,0.00021,0.008253
1185142948385689600,1185142948385689600,,1,0,1,1,0,1,0,0,0,0,9,0.00021,0
1443878994378739712,1443878994378739712,,1,1,2,1,1,2,2,0.666667,0.75,0,9,0.00021,0.017924
186055068,186055068,,1,1,2,1,1,2,7,0.283203,0.300698,0,9,0.00021,0.004809
432654926,432654926,,1,0,1,1,0,1,0,0,0,0,9,0.00021,0
728907222,728907222,,1,0,1,1,0,1,0,0,0,0,9,0.00021,0
1260526777295949824,1260526777295949824,,1,0,1,1,0,1,0,0,0,0,9,0.00021,0
136317670,136317670,,1,0,1,1,0,1,0,0,0,0,9,0.00021,0
1227194803,1227194803,,1,0,1,1,0,1,0,0,0,0,9,0.00021,0
1421365006134820864,1421365006134820864,,1,1,2,1,1,2,2,0.666667,0.75,0,9,0.00021,0.017924
103303397,103303397,,1,1,2,1,1,2,2,0.666667,0.75,0,9,0.00021,0.020692
1377720037893672960,1377720037893672960,,1,1,2,1,1,2,6,0.390411,0.429474,0.000012,9,0.00021,0.00415
359905096,359905096,,1,0,1,1,0,1,0,0,0,0,9,0.00021,0
484363680,484363680,,1,0,1,1,0,1,0,0,0,0,9,0.00021,0
3230609223,3230609223,,1,0,1,1,0,1,0,0,0,0,9,0.00021,0
925761852,925761852,,1,1,2,1,1,2,3,0.5,0.611111,0.00001,9,0.00021,0.000018
1238853351313465344,1238853351313465344,,1,0,1,1,0,1,0,0,0,0,9,0.00021,0
1243934210672472064,1243934210672472064,,1,0,1,1,0,1,0,0,0,0,9,0.00021,0
1444542292577107968,1444542292577107968,,1,0,1,1,0,1,0,0,0,0,9,0.00021,0
328961813,328961813,,1,0,1,1,0,1,0,0,0,0,9,0.00021,0
1305225313836822528,1305225313836822528,,1,1,2,1,1,2,2,0.666667,0.75,0,9,0.00021,0.017924
1227144498,1227144498,,1,2,3,1,2,3,7,0.235294,0.28355,0.000013,37,0.00021,0.020711
1215273083965231104,1215273083965231104,,1,2,3,1,2,3,7,0.283902,0.303101,0.000006,15,0.00021,0.004919
1398385412268232704,1398385412268232704,,1,0,1,1,0,1,0,0,0,0,9,0.00021,0
1348857442705305600,1348857442705305600,,1,0,1,1,0,1,0,0,0,0,9,0.00021,0
1289995760507985920,1289995760507985920,,1,1,2,1,1,2,2,0.666667,0.75,0,9,0.00021,0.017924
597545163,597545163,,1,2,3,1,2,3,3,0.571429,0.708333,0.000009,13,0.00021,0.001579
1241103477557911552,1241103477557911552,,1,1,2,1,1,2,2,0.666667,0.75,0,9,0.00021,0.017924
1207393363676344320,1207393363676344320,,1,2,3,1,2,3,3,0.5,0.537037,0.00006,9,0.00021,0.018195
1433496996149698560,1433496996149698560,,1,0,1,1,0,1,0,0,0,0,9,0.00021,0
431681063,431681063,,1,0,1,1,0,1,0,0,0,0,9,0.00021,0
56646271,56646271,,1,1,2,1,1,2,2,0.666667,0.75,0,9,0.00021,0.020692
4309630395,4309630395,,1,0,1,1,0,1,0,0,0,0,9,0.00021,0
2166970213,2166970213,,1,1,2,1,1,2,2,0.666667,0.75,0,9,0.00021,0.020692
337152978,337152978,,1,1,2,1,1,2,7,0.272226,0.304285,0.000037,14,0.00021,0.002135
1413893534248325120,1413893534248325120,,1,0,1,1,0,1,0,0,0,0,9,0.00021,0
8882322,8882322,,1,0,1,1,0,1,0,0,0,0,9,0.00021,0
361124657,361124657,,1,0,1,1,0,1,0,0,0,0,9,0.00021,0
1136656067654557696,1136656067654557696,,1,2,3,1,2,3,2,0.666667,0.75,0,9,0.00021,0.038617
1295297295798411264,1295297295798411264,,1,2,3,1,2,3,4,0.414286,0.462644,0.000022,25,0.00021,0.00099
962922916999585792,962922916999585792,,1,0,1,1,0,1,0,0,0,0,9,0.00021,0
1442927061497176064,1442927061497176064,,1,1,2,1,1,2,2,0.666667,0.75,0,9,0.00021,0.017924
1138580275166887936,1138580275166887936,,1,1,2,1,1,2,1,1,1,0.000007,13,0.00021,0.000003
750752094840320000,750752094840320000,,1,1,2,1,1,2,2,0.666667,0.75,0,9,0.00021,0.017924
3063894915,3063894915,,1,0,1,1,0,1,0,0,0,0,9,0.00021,0
1448245068536729600,1448245068536729600,,1,2,3,1,2,3,6,0.391363,0.431264,0.000012,9,0.00021,0.008958
1079672562857193472,1079672562857193472,,1,1,2,1,1,2,6,0.390411,0.429474,0.000012,9,0.00021,0.00415
3039450687,3039450687,,1,1,2,1,1,2,2,0.666667,0.75,0,9,0.00021,0.017924
1217087224711471104,1217087224711471104,,1,1,2,1,1,2,6,0.390411,0.429474,0.000012,9,0.00021,0.00415
1345367203781226496,1345367203781226496,,1,0,1,1,0,1,0,0,0,0,9,0.00021,0
1380117973097152512,1380117973097152512,,1,0,1,1,0,1,0,0,0,0,9,0.00021,0
1433677148162863104,1433677148162863104,,1,1,2,1,1,2,7,0.283203,0.300698,0,9,0.00021,0.004809
479728037,479728037,,1,0,1,1,0,1,0,0,0,0,9,0.00021,0
883249698873778176,883249698873778176,,1,2,3,1,2,3,6,0.391484,0.431813,0.000012,9,0.00021,0.022074
2333638607,2333638607,,1,0,1,1,0,1,0,0,0,0,9,0.00021,0
1196018762593525760,1196018762593525760,,1,3,4,1,5,6,5,0.442308,0.478744,0.000021,15,0.00021,0.019669
907512589667766272,907512589667766272,,1,0,1,1,0,1,0,0,0,0,9,0.00021,0
1238014383512485888,1238014383512485888,,1,0,1,1,0,1,0,0,0,0,9,0.00021,0
2303836510,2303836510,,1,0,1,1,0,1,0,0,0,0,9,0.00021,0
2529337990,2529337990,,0,1,1,0,1,1,2,0.666667,0.75,0,5,0,0.020692
1415030380969738240,1415030380969738240,,0,0,0,0,0,0,0,0,0,0,211,0,0
2330388670,2330388670,,0,2,2,0,3,3,6,0.392718,0.432064,0,28,0,0.004154
3025558675,3025558675,,0,1,1,0,1,1,2,0.666667,0.75,0,5,0,0.020692
3302783938,3302783938,,0,0,0,0,0,0,0,0,0,0,212,0,0
715878438079438848,715878438079438848,,0,0,0,0,0,0,0,0,0,0,213,0,0
1330133173636894720,1330133173636894720,,0,1,1,0,1,1,2,0.666667,0.75,0,13,0,0.017924
1429529723739250688,1429529723739250688,,0,1,1,0,1,1,2,0.555556,0.6,0,14,0,0.000084
99702635,99702635,,0,5,5,0,5,5,7,0.280806,0.320188,0,13,0,0.021582
401523993,401523993,,0,1,1,0,1,1,2,0.666667,0.75,0,5,0,0.020692
971816547898490880,971816547898490880,,0,2,2,0,2,2,6,0.391542,0.431707,0,33,0,0.004153
939082337345818624,939082337345818624,,0,0,0,0,0,0,0,0,0,0,214,0,0
1331695314735140864,1331695314735140864,,0,1,1,0,1,1,2,0.666667,0.75,0,5,0,0.020692
377399824,377399824,,0,1,1,0,1,1,7,0.272226,0.304285,0,14,0,0.002135
1640890879,1640890879,,0,1,1,0,1,1,2,0.666667,0.75,0,5,0,0.020692
44216765,44216765,,0,1,1,0,1,1,2,0.666667,0.75,0,5,0,0.020692
225579888,225579888,,0,1,1,0,1,1,2,0.666667,0.75,0,5,0,0.020692
1428403640843264000,1428403640843264000,,0,1,1,0,1,1,1,1,1,0,9,0,0.000612
555374641,555374641,,2,0,2,3,0,3,0,0,0,0,17,0.000291,0
1384350327420379136,1384350327420379136,,0,1,1,0,1,1,2,0.666667,0.75,0,5,0,0.020692
1331828562,1331828562,,0,1,1,0,1,1,2,0.666667,0.75,0,5,0,0.020692
1437834134282457088,1437834134282457088,,0,0,0,0,0,0,0,0,0,0,215,0,0
74164099,74164099,,0,2,2,0,2,2,5,0.432099,0.465952,0,15,0,0.022282
263707432,263707432,,0,2,2,0,2,2,7,0.272895,0.306349,0,14,0,0.020059
1385709282,1385709282,,0,2,2,0,2,2,1,1,1,0,37,0,0.024137
453160837,453160837,,0,1,1,0,1,1,2,0.666667,0.75,0,28,0,0.000006
595531490,595531490,,1,0,1,1,0,1,0,0,0,0,18,0.000145,0
241519703,241519703,,1,1,2,1,1,2,1,1,1,0,18,0.000145,0.000245
1409402014224764928,1409402014224764928,,1,0,1,1,0,1,0,0,0,0,18,0.000145,0
1258828655591075840,1258828655591075840,,1,0,1,1,0,1,0,0,0,0,18,0.000145,0
3197165667,3197165667,,1,0,1,1,0,1,0,0,0,0,18,0.000145,0
1382592945723998208,1382592945723998208,,1,0,1,1,0,1,0,0,0,0,18,0.000145,0
222888401,222888401,,1,1,2,1,1,2,2,0.666667,0.75,0,18,0.000145,0.020692
412091762,412091762,,0,1,1,0,1,1,1,1,1,0,9,0,0.000612
898620354045911040,898620354045911040,,0,1,1,0,1,1,7,0.283203,0.300698,0,9,0,0.004809
732914396247261184,732914396247261184,,0,1,1,0,1,1,1,1,1,0,9,0,0.000612
839498038951411712,839498038951411712,,0,1,1,0,1,1,2,0.666667,0.75,0,5,0,0.020692
64789750,64789750,,0,0,0,0,0,0,0,0,0,0,216,0,0
2346512655,2346512655,,0,1,1,0,1,1,7,0.272226,0.304285,0,14,0,0.002135
924750434,924750434,,0,2,2,0,2,2,1,1,1,0,37,0,0.024137
1103360481341902848,1103360481341902848,,0,3,3,0,3,3,5,0.451317,0.474535,0,15,0,0.000096
1440593736774275072,1440593736774275072,,3,1,4,3,2,5,1,1,1,0,15,0.001134,0
1248341835770200064,1248341835770200064,,0,1,1,0,1,1,7,0.283203,0.300698,0,9,0,0.004809
2166414502,2166414502,,0,0,0,0,0,0,0,0,0,0,217,0,0
887663253970726912,887663253970726912,,0,1,1,0,1,1,2,0.666667,0.75,0,5,0,0.020692
1938254768,1938254768,,0,3,3,0,3,3,2,0.571429,0.625,0,15,0,0.038965
1443193835040002048,1443193835040002048,,0,1,1,0,1,1,7,0.283203,0.300698,0,9,0,0.004809
1035460693,1035460693,,0,1,1,0,1,1,2,0.666667,0.75,0,13,0,0.017924
252566833,252566833,,0,1,1,0,1,1,2,0.666667,0.75,0,5,0,0.020692
2955233225,2955233225,,0,2,2,0,2,2,7,0.284593,0.304146,0,21,0,0.005757
930328482,930328482,,0,1,1,0,1,1,2,0.555556,0.6,0,14,0,0.000084
1426290305096167424,1426290305096167424,,0,1,1,0,1,1,2,0.666667,0.75,0,5,0,0.020692
1349940787161796608,1349940787161796608,,0,2,2,0,2,2,2,0.75,0.833333,0,5,0,0.000246
610648955,610648955,,1,1,2,1,2,3,1,1,1,0,5,0.000007,0
103230986,103230986,,0,1,1,0,1,1,2,0.666667,0.75,0,5,0,0.020692
245960120,245960120,,0,1,1,0,1,1,2,0.666667,0.75,0,5,0,0.020692
812681976,812681976,,0,2,2,0,2,2,2,0.666667,0.75,0,5,0,0.038617
1027180824335208448,1027180824335208448,,0,1,1,0,1,1,1,1,1,0,9,0,0.000612
1276356233214283776,1276356233214283776,,0,1,1,0,1,1,2,0.666667,0.75,0,5,0,0.020692
89029069,89029069,,0,1,1,0,1,1,7,0.272226,0.304285,0,14,0,0.002135
1255206419944607744,1255206419944607744,,0,1,1,0,1,1,2,0.666667,0.75,0,5,0,0.020692
1920146359,1920146359,,1,0,1,2,0,2,0,0,0,0,5,0,0
396151080,396151080,,0,1,1,0,1,1,1,1,1,0,218,0,0
14824456,14824456,,1,0,1,1,0,1,0,0,0,0,218,0,0
1046779574892339200,1046779574892339200,,0,0,0,0,0,0,0,0,0,0,219,0,0
608955220,608955220,,0,1,1,0,1,1,1,1,1,0,13,0,0.000584
1196421889192804352,1196421889192804352,,0,1,1,0,1,1,1,1,1,0,9,0,0.000612
20972743,20972743,,0,1,1,0,1,1,2,0.666667,0.75,0,5,0,0.020692
1346905633463922688,1346905633463922688,,0,1,1,0,1,1,1,1,1,0,9,0,0.000612
1354143264132231168,1354143264132231168,,0,1,1,0,1,1,2,0.666667,0.75,0,13,0,0.017924
4818612196,4818612196,,0,2,2,0,2,2,2,0.75,0.833333,0,15,0,0.019393
2993910472,2993910472,,0,1,1,0,1,1,1,1,1,0,28,0,0.000001
1448595881197019136,1448595881197019136,,0,1,1,0,1,1,2,0.666667,0.75,0,13,0,0.017924
1133775925873664000,1133775925873664000,,0,3,3,0,4,4,3,0.516667,0.543011,0,13,0,0.039619
4662894796,4662894796,,0,1,1,0,1,1,2,0.666667,0.75,0,5,0,0.020692
1436374555745034240,1436374555745034240,,0,1,1,0,1,1,1,1,1,0,9,0,0.000612
796082544215212032,796082544215212032,,0,2,2,0,2,2,7,0.272895,0.306086,0,9,0,0.002443
1349680836896030720,1349680836896030720,,0,1,1,0,1,1,7,0.283203,0.300698,0,9,0,0.004809
1117284122723061760,1117284122723061760,,0,2,2,0,2,2,1,1,1,0,9,0,0.001555
2256723448,2256723448,,0,0,0,0,0,0,0,0,0,0,220,0,0
1290588940731326464,1290588940731326464,,0,4,4,0,4,4,4,0.5,0.542929,0,9,0,0.023347
1442055970041913344,1442055970041913344,,0,1,1,0,1,1,1,1,1,0,9,0,0.000612
730484710850318336,730484710850318336,,0,2,2,0,2,2,5,0.432099,0.465952,0,15,0,0.022282
598464327,598464327,,0,1,1,0,1,1,1,1,1,0,13,0,0.000584
3028809503,3028809503,,0,2,2,0,2,2,1,1,1,0,9,0,0.002126
950339922602479616,950339922602479616,,0,2,2,0,2,2,2,0.75,0.833333,0,21,0,0.000682
1379520397,1379520397,,0,3,3,0,3,3,7,0.273006,0.307346,0,37,0,0.005684
50827580,50827580,,0,2,2,0,2,2,1,1,1,0,9,0,0.004057
856781106468855808,856781106468855808,,0,4,4,0,4,4,7,0.27351,0.309219,0,14,0,0.024403
1218946952924213248,1218946952924213248,,0,4,4,0,4,4,2,0.75,0.833333,0,5,0,0.039475
1448593216752824320,1448593216752824320,,0,0,0,0,0,0,0,0,0,0,221,0,0
1004967978386026496,1004967978386026496,,0,2,2,0,2,2,2,0.583333,0.642857,0,14,0,0.020776
2591510034,2591510034,,0,2,2,0,2,2,7,0.272895,0.306349,0,14,0,0.020059
2815401849,2815401849,,0,1,1,0,1,1,7,0.272226,0.304285,0,14,0,0.002135
2569072195,2569072195,,0,0,0,0,0,0,0,0,0,0,222,0,0
130537001,130537001,,3,0,3,6,0,6,0,0,0,0,13,0.001799,0
1379748756955017216,1379748756955017216,,0,0,0,0,0,0,0,0,0,0,223,0,0
607236289,607236289,,0,1,1,0,1,1,7,0.272226,0.304285,0,14,0,0.002135
1417869346689458176,1417869346689458176,,0,1,1,0,1,1,7,0.272226,0.304285,0,14,0,0.002135
142609008,142609008,,0,0,0,0,0,0,0,0,0,0,224,0,0
1135262496,1135262496,,0,1,1,0,1,1,2,0.666667,0.75,0,5,0,0.020692
2247093145,2247093145,,0,1,1,0,1,1,7,0.283203,0.300698,0,9,0,0.004809
3108618777,3108618777,,0,2,2,0,2,2,7,0.272895,0.306349,0,14,0,0.020059
1435124359711150080,1435124359711150080,,0,1,1,0,1,1,1,1,1,0,9,0,0.000612
345868946,345868946,,0,2,2,0,2,2,7,0.272895,0.306349,0,14,0,0.020059
507118418,507118418,,0,6,6,0,8,8,6,0.385417,0.429129,0,14,0,0.013863
2578642498,2578642498,,0,1,1,0,1,1,2,0.666667,0.75,0,5,0,0.020692
1224996284,1224996284,,0,3,3,0,3,3,2,0.714286,0.8,0,25,0,0.039237
600073468,600073468,,0,1,1,0,1,1,7,0.272226,0.304285,0,14,0,0.002135
1424426679481536512,1424426679481536512,,0,0,0,0,0,0,0,0,0,0,225,0,0
492366149,492366149,,2,2,4,3,3,6,1,1,1,0.00001,15,0.000531,0.00147
1450052180963205120,1450052180963205120,,0,0,0,0,0,0,0,0,0,0,226,0,0
594443756,594443756,,1,0,1,2,0,2,0,0,0,0,14,0.000008,0
3080569749,3080569749,,1,0,1,3,0,3,0,0,0,0,14,0.000008,0
1437860579763499008,1437860579763499008,,1,0,1,2,0,2,0,0,0,0,14,0.000008,0
1487361265,1487361265,,1,1,2,1,1,2,1,1,1,0.000001,21,0.000008,0.000866
777845439148224512,777845439148224512,,2,2,4,2,2,4,1,1,1,0.000002,9,0.000009,0.001903
481375605,481375605,,1,0,1,1,0,1,0,0,0,0,14,0.000008,0
1476948512,1476948512,,1,0,1,1,0,1,0,0,0,0,14,0.000008,0
1425830479006035968,1425830479006035968,,2,0,2,2,0,2,0,0,0,0,14,0.000639,0
1168153485843607552,1168153485843607552,,1,0,1,1,0,1,0,0,0,0,14,0.000008,0
470554249,470554249,,1,0,1,1,0,1,0,0,0,0,14,0.000008,0
1361385459734220800,1361385459734220800,,1,0,1,1,0,1,0,0,0,0,14,0.000008,0
1407376148602949632,1407376148602949632,,1,0,1,1,0,1,0,0,0,0,14,0.000008,0
1434592998143283200,1434592998143283200,,1,0,1,1,0,1,0,0,0,0,14,0.000008,0
1392798872590766080,1392798872590766080,,1,1,2,1,1,2,2,0.666667,0.75,0,14,0.000008,0.017924
462763787,462763787,,1,0,1,1,0,1,0,0,0,0,14,0.000008,0
1397217753317224448,1397217753317224448,,1,1,2,1,1,2,2,0.666667,0.75,0,14,0.000008,0.017924
243838203,243838203,,1,0,1,1,0,1,0,0,0,0,14,0.000008,0
2779725371,2779725371,,1,1,2,1,1,2,2,0.666667,0.75,0.000001,21,0.000008,0.000949
439131272,439131272,,1,0,1,1,0,1,0,0,0,0,14,0.000008,0
2186447350,2186447350,,1,0,1,1,0,1,0,0,0,0,14,0.000008,0
822810410906779648,822810410906779648,,1,0,1,1,0,1,0,0,0,0,14,0.000008,0
510248977,510248977,,1,1,2,1,1,2,1,1,1,0,14,0.000008,0.003445
1331104358,1331104358,,1,0,1,1,0,1,0,0,0,0,14,0.000008,0
2811563782,2811563782,,1,3,4,1,4,5,3,0.508197,0.537634,0.000015,13,0.000008,0.019511
1033063771516878848,1033063771516878848,,1,0,1,1,0,1,0,0,0,0,14,0.000008,0
1430627305655767040,1430627305655767040,,1,3,4,1,4,5,7,0.284457,0.305392,0.000013,13,0.000008,0.022752
3012195082,3012195082,,1,0,1,1,0,1,0,0,0,0,14,0.000008,0
859297213322854400,859297213322854400,,2,1,3,2,1,3,1,1,1,0.000001,25,0.000011,0.00062
928373996306993152,928373996306993152,,1,0,1,1,0,1,0,0,0,0,14,0.000008,0
703871432690933760,703871432690933760,,1,0,1,1,0,1,0,0,0,0,14,0.000008,0
4040685951,4040685951,,1,1,2,1,1,2,1,1,1,0,25,0.000008,0.00062
1433843809306222592,1433843809306222592,,1,0,1,1,0,1,0,0,0,0,14,0.000008,0
1430117703331819520,1430117703331819520,,1,0,1,1,0,1,0,0,0,0,14,0.000008,0
1412387815904665600,1412387815904665600,,1,0,1,1,0,1,0,0,0,0,14,0.000008,0
3779933494,3779933494,,1,0,1,1,0,1,0,0,0,0,14,0.000008,0
2320580560,2320580560,,1,1,2,1,1,2,1,1,1,0,14,0.000008,0.001513
738448251578355712,738448251578355712,,2,0,2,2,0,2,0,0,0,0,14,0.000639,0
1432801281081548800,1432801281081548800,,1,2,3,1,2,3,7,0.284035,0.303284,0.000002,14,0.000008,0.006322
1368133749993594880,1368133749993594880,,1,0,1,1,0,1,0,0,0,0,14,0.000008,0
2148581297,2148581297,,2,2,4,2,2,4,4,0.476923,0.508065,0.000018,15,0.000008,0.001392
1251245694096113664,1251245694096113664,,1,0,1,1,0,1,0,0,0,0,14,0.000008,0
805787362148093952,805787362148093952,,2,0,2,2,0,2,0,0,0,0,14,0.00001,0
1089122693906132992,1089122693906132992,,1,1,2,1,1,2,1,1,1,0,15,0.000008,0.001469
1264219569817890816,1264219569817890816,,1,0,1,1,0,1,0,0,0,0,14,0.000008,0
1253740719728189440,1253740719728189440,,1,3,4,1,5,6,2,0.714286,0.8,0.000001,13,0.000008,0.04013
1209249979744817152,1209249979744817152,,2,0,2,2,0,2,0,0,0,0,14,0.000639,0
1445155424425099264,1445155424425099264,,1,0,1,1,0,1,0,0,0,0,14,0.000008,0
49327792,49327792,,1,0,1,1,0,1,0,0,0,0,14,0.000008,0
383254576,383254576,,1,0,1,1,0,1,0,0,0,0,14,0.000008,0
1001675840,1001675840,,1,0,1,1,0,1,0,0,0,0,14,0.000008,0
55563212,55563212,,1,0,1,1,0,1,0,0,0,0,14,0.000008,0
982582749390426112,982582749390426112,,1,0,1,1,0,1,0,0,0,0,14,0.000008,0
2863617446,2863617446,,1,0,1,1,0,1,0,0,0,0,14,0.000008,0
1421818373785202688,1421818373785202688,,1,2,3,1,3,4,2,0.666667,0.75,0.000001,13,0.000008,0.038617
3684132136,3684132136,,2,0,2,2,0,2,0,0,0,0,14,0.000639,0
837727775192674304,837727775192674304,,1,0,1,1,0,1,0,0,0,0,14,0.000008,0
315438318,315438318,,1,0,1,1,0,1,0,0,0,0,14,0.000008,0
1021306837,1021306837,,2,1,3,2,1,3,1,1,1,0.000001,14,0.00001,0.00062
426868617,426868617,,1,0,1,1,0,1,0,0,0,0,14,0.000008,0
1002640726876925952,1002640726876925952,,1,0,1,1,0,1,0,0,0,0,14,0.000008,0
796855512461639680,796855512461639680,,1,0,1,1,0,1,0,0,0,0,14,0.000008,0
1242550162117079040,1242550162117079040,,1,0,1,1,0,1,0,0,0,0,14,0.000008,0
1367102851,1367102851,,1,1,2,1,1,2,1,1,1,0,15,0.000008,0.001469
1334184957166702592,1334184957166702592,,1,0,1,1,0,1,0,0,0,0,14,0.000008,0
213362253,213362253,,1,0,1,1,0,1,0,0,0,0,14,0.000008,0
455888650,455888650,,1,1,2,1,1,2,2,0.666667,0.75,0,14,0.000008,0.017924
705284330931802112,705284330931802112,,1,1,2,1,1,2,2,0.666667,0.75,0,14,0.000008,0.017924
1169529988481191936,1169529988481191936,,1,0,1,1,0,1,0,0,0,0,14,0.000008,0
105538883,105538883,,1,0,1,1,0,1,0,0,0,0,14,0.000008,0
2675356905,2675356905,,2,2,4,2,2,4,4,0.4,0.5,0.000124,13,0.000639,0.01794
1050872748,1050872748,,1,0,1,1,0,1,0,0,0,0,14,0.000008,0
236878203,236878203,,2,0,2,2,0,2,0,0,0,0,14,0.000008,0
1420475901846999040,1420475901846999040,,1,0,1,1,0,1,0,0,0,0,14,0.000008,0
1276860697301966848,1276860697301966848,,2,1,3,2,1,3,1,1,1,0.000001,14,0.000639,0.001513
854667559,854667559,,1,0,1,1,0,1,0,0,0,0,14,0.000008,0
1350769627,1350769627,,1,0,1,1,0,1,0,0,0,0,14,0.000008,0
446397123,446397123,,1,0,1,1,0,1,0,0,0,0,14,0.000008,0
791387642487275520,791387642487275520,,1,0,1,1,0,1,0,0,0,0,14,0.000008,0
1223233405191622656,1223233405191622656,,1,0,1,1,0,1,0,0,0,0,14,0.000008,0
4307491347,4307491347,,1,0,1,1,0,1,0,0,0,0,14,0.000008,0
4684289622,4684289622,,1,0,1,1,0,1,0,0,0,0,14,0.000008,0
1259845316033105920,1259845316033105920,,1,0,1,1,0,1,0,0,0,0,14,0.000008,0
1408567643662127104,1408567643662127104,,0,3,3,0,3,3,7,0.285156,0.306344,0,9,0,0.026113
131511128,131511128,,0,0,0,0,0,0,0,0,0,0,227,0,0
10331712,10331712,,0,0,0,0,0,0,0,0,0,0,228,0,0
848005772,848005772,,0,2,2,0,2,2,2,0.75,0.833333,0,15,0,0.020728
1167614283854897152,1167614283854897152,,0,1,1,0,1,1,2,0.666667,0.75,0,5,0,0.020692
1244609569,1244609569,,0,1,1,0,1,1,1,1,1,0,28,0,0
1140930793,1140930793,,0,2,2,0,2,2,2,0.75,0.833333,0,15,0,0.022161
1086810552,1086810552,,0,1,1,0,1,1,5,0.449942,0.471782,0,28,0,0.000046
2378654494,2378654494,,0,2,2,0,2,2,7,0.284457,0.30396,0,9,0,0.025501
1062862212,1062862212,,0,1,1,0,1,1,2,0.666667,0.75,0,5,0,0.020692
2722837953,2722837953,,0,0,0,0,0,0,0,0,0,0,229,0,0
1431731626158006272,1431731626158006272,,0,0,0,0,0,0,0,0,0,0,230,0,0
1418997363457282048,1418997363457282048,,0,1,1,0,1,1,7,0.283203,0.300698,0,9,0,0.004809
997845443190157312,997845443190157312,,0,1,1,0,1,1,2,0.666667,0.75,0,5,0,0.020692
879999716397899776,879999716397899776,,0,1,1,0,1,1,2,0.555556,0.6,0,14,0,0.000084
1389146516376494080,1389146516376494080,,0,1,1,0,1,1,2,0.666667,0.75,0,13,0,0.017924
1467807296,1467807296,,0,0,0,0,0,0,0,0,0,0,231,0,0
1405137015675437056,1405137015675437056,,0,2,2,0,2,2,2,0.666667,0.75,0,21,0,0.021641
1033993296203472896,1033993296203472896,,0,1,1,0,1,1,2,0.666667,0.75,0,5,0,0.020692
960214322315190272,960214322315190272,,1,0,1,2,0,2,0,0,0,0,14,0,0
1408908776086900736,1408908776086900736,,1,0,1,1,0,1,0,0,0,0,14,0,0
2719470235,2719470235,,1,0,1,1,0,1,0,0,0,0,14,0,0
368588066,368588066,,1,0,1,1,0,1,0,0,0,0,14,0,0
1241305471497183232,1241305471497183232,,0,1,1,0,1,1,2,0.666667,0.75,0,5,0,0.020692
437718283,437718283,,0,1,1,0,1,1,2,0.666667,0.75,0,5,0,0.020692
372799374,372799374,,0,1,1,0,1,1,2,0.666667,0.75,0,5,0,0.020692
21768907,21768907,,0,2,2,0,2,2,1,1,1,0,232,0,0
2269616428,2269616428,,1,0,1,1,0,1,0,0,0,0,232,0,0
3195217666,3195217666,,1,0,1,1,0,1,0,0,0,0,232,0,0
1210020241885007872,1210020241885007872,,0,1,1,0,1,1,1,1,1,0,15,0,0.00007
1184147629673988096,1184147629673988096,,0,1,1,0,1,1,7,0.283203,0.300698,0,9,0,0.004809
1340283499635478528,1340283499635478528,,0,1,1,0,1,1,1,1,1,0,13,0,0.000584
1441708508387307520,1441708508387307520,,0,2,2,0,2,2,2,0.75,0.833333,0,5,0,0.020938
1171075794292092928,1171075794292092928,,0,1,1,0,1,1,2,0.666667,0.75,0,5,0,0.020692
51518999,51518999,,0,1,1,0,1,1,1,1,1,0,233,0,0
442800156,442800156,,1,0,1,1,0,1,0,0,0,0,233,0,0
2433235432,2433235432,,0,1,1,0,1,1,2,0.666667,0.75,0,5,0,0.020692
1346186339771969536,1346186339771969536,,0,1,1,0,1,1,2,0.666667,0.75,0,5,0,0.020692
2744423331,2744423331,,0,1,1,0,1,1,7,0.283203,0.300698,0,9,0,0.004809
585968039,585968039,,0,1,1,0,1,1,2,0.666667,0.75,0,5,0,0.020692
285756670,285756670,,0,1,1,0,1,1,2,0.666667,0.75,0,5,0,0.020692
1239559948822077440,1239559948822077440,,0,1,1,0,1,1,2,0.666667,0.75,0,5,0,0.020692
1216344705052573696,1216344705052573696,,0,1,1,0,1,1,1,1,1,0,234,0,0
125107486,125107486,,1,0,1,1,0,1,0,0,0,0,234,0,0
841804147,841804147,,0,0,0,0,0,0,0,0,0,0,235,0,0
543774554,543774554,,3,0,3,6,0,6,0,0,0,0,5,0.001212,0
1394017202420977664,1394017202420977664,,0,1,1,0,1,1,2,0.666667,0.75,0,5,0,0.020692
973465514,973465514,,0,2,2,0,2,2,2,0.75,0.833333,0,5,0,0.02071
1121099290233987072,1121099290233987072,,1,0,1,1,0,1,0,0,0,0,5,0.000605,0
939878360,939878360,,0,1,1,0,1,1,2,0.666667,0.75,0,5,0,0.020692
1444046996143284224,1444046996143284224,,0,1,1,0,1,1,2,0.666667,0.75,0,5,0,0.020692
1438482991932747776,1438482991932747776,,0,1,1,0,1,1,2,0.666667,0.75,0,13,0,0.017924
467288306,467288306,,0,0,0,0,0,0,0,0,0,0,236,0,0
229298725,229298725,,0,1,1,0,1,1,2,0.666667,0.75,0,5,0,0.020692
3543076336,3543076336,,0,1,1,0,1,1,2,0.666667,0.75,0,5,0,0.020692
1411649505624219648,1411649505624219648,,0,3,3,0,3,3,2,0.714286,0.8,0,5,0,0.038687
2525155376,2525155376,,0,1,1,0,1,1,2,0.666667,0.75,0,5,0,0.020692
1422543606137634816,1422543606137634816,,0,0,0,0,0,0,0,0,0,0,237,0,0
1222977289530617856,1222977289530617856,,0,0,0,0,0,0,0,0,0,0,238,0,0
2674688175,2674688175,,0,1,1,0,1,1,2,0.666667,0.75,0,5,0,0.020692
1168701144,1168701144,,0,1,1,0,1,1,2,0.666667,0.75,0,5,0,0.020692
1275548215,1275548215,,1,0,1,2,0,2,0,0,0,0,9,0.000622,0
326150500,326150500,,0,1,1,0,1,1,2,0.666667,0.75,0,5,0,0.020692
1295304860984840192,1295304860984840192,,0,1,1,0,1,1,2,0.666667,0.75,0,5,0,0.020692
1415346528969965568,1415346528969965568,,0,3,3,0,3,3,5,0.451317,0.474535,0,28,0,0.020756
804961884,804961884,,5,0,5,5,0,5,0,0,0,0,28,0.000608,0
1166950205931040768,1166950205931040768,,0,1,1,0,1,1,2,0.666667,0.75,0,5,0,0.020692
1318299709006614528,1318299709006614528,,0,1,1,0,1,1,2,0.666667,0.75,0,5,0,0.020692
399026945,399026945,,0,2,2,0,2,2,6,0.391781,0.432051,0,9,0,0.024842
927553962,927553962,,0,1,1,0,1,1,2,0.666667,0.75,0,5,0,0.020692
348661373,348661373,,0,1,1,0,1,1,1,1,1,0,239,0,0
52206737,52206737,,1,0,1,1,0,1,0,0,0,0,239,0,0
1229690231709982720,1229690231709982720,,0,1,1,0,1,1,1,1,1,0,5,0,0.000237
1199378413322145792,1199378413322145792,,0,1,1,0,1,1,2,0.666667,0.75,0,5,0,0.020692
731407491884564480,731407491884564480,,0,0,0,0,0,0,0,0,0,0,240,0,0
1355767833922306048,1355767833922306048,,0,0,0,0,0,0,0,0,0,0,241,0,0
1363122972572200960,1363122972572200960,,0,1,1,0,1,1,1,1,1,0,242,0,0
1095354780,1095354780,,1,0,1,1,0,1,0,0,0,0,242,0,0
2283973057,2283973057,,0,1,1,0,1,1,2,0.666667,0.75,0,5,0,0.020692
1173514152737988608,1173514152737988608,,0,1,1,0,1,1,2,0.666667,0.75,0,5,0,0.020692
1430183847463895040,1430183847463895040,,0,1,1,0,1,1,2,0.666667,0.75,0,5,0,0.020692
1344997483429179392,1344997483429179392,,0,1,1,0,1,1,2,0.666667,0.75,0,5,0,0.020692
1018468604843618304,1018468604843618304,,0,2,2,0,2,2,1,1,1,0,37,0,0.024137
51037275,51037275,,0,1,1,0,1,1,2,0.666667,0.75,0,5,0,0.020692
1685222786,1685222786,,0,1,1,0,1,1,2,0.666667,0.75,0,5,0,0.020692
493285850,493285850,,0,1,1,0,1,1,2,0.666667,0.75,0,15,0,0.000033
3040947953,3040947953,,0,1,1,0,1,1,2,0.571429,0.625,0,17,0,0
2971373548,2971373548,,1,3,4,1,5,6,1,1,1,0,17,0,0.001523
3385710711,3385710711,,0,1,1,0,1,1,2,0.666667,0.75,0,5,0,0.020692
1112851430354927616,1112851430354927616,,0,1,1,0,1,1,2,0.666667,0.75,0,5,0,0.020692
496866833,496866833,,0,0,0,0,0,0,0,0,0,0,243,0,0
1105021068,1105021068,,0,2,2,0,2,2,2,0.666667,0.75,0,5,0,0.038617
1432044081870430208,1432044081870430208,,0,1,1,0,1,1,2,0.666667,0.75,0,5,0,0.020692
1443511161597595648,1443511161597595648,,0,1,1,0,1,1,2,0.666667,0.75,0,5,0,0.020692
312675024,312675024,,0,0,0,0,0,0,0,0,0,0,244,0,0
1681418767,1681418767,,0,1,1,0,1,1,2,0.666667,0.75,0,13,0,0.017924
1084397318,1084397318,,1,0,1,2,0,2,0,0,0,0,206,0.00113,0
1431631014258958336,1431631014258958336,,0,1,1,0,1,1,2,0.666667,0.75,0,5,0,0.020692
1266679254793818112,1266679254793818112,,0,0,0,0,0,0,0,0,0,0,245,0,0
2274787244,2274787244,,0,1,1,0,1,1,2,0.666667,0.75,0,5,0,0.020692
265408261,265408261,,0,1,1,0,1,1,1,1,1,0,28,0,0.000001
1003654303,1003654303,,0,1,1,0,1,1,7,0.283203,0.300698,0,9,0,0.004809
1043435909302112256,1043435909302112256,,0,0,0,0,0,0,0,0,0,0,246,0,0
85832733,85832733,,0,0,0,0,0,0,0,0,0,0,247,0,0
277386492,277386492,,0,1,1,0,1,1,1,1,1,0,5,0,0.000245
1436370361516441600,1436370361516441600,,0,1,1,0,1,1,7,0.283203,0.300698,0,9,0,0.004809
636328779,636328779,,2,0,2,4,0,4,0,0,0,0,110,0.000802,0
962989620,962989620,,1,0,1,1,0,1,0,0,0,0,13,0.000525,0
563529644,563529644,,1,2,3,1,2,3,6,0.394771,0.433996,0.000016,25,0.000525,0.00452
350810508,350810508,,1,1,2,1,1,2,1,1,1,0.000006,13,0.000525,0
1417930527299055616,1417930527299055616,,0,1,1,0,1,1,2,0.666667,0.75,0,13,0,0.017924
2452494826,2452494826,,0,4,4,0,5,5,2,0.75,0.833333,0,13,0,0.039593
496273212,496273212,,1,0,1,1,0,1,0,0,0,0,13,0.001157,0
1275085404442591232,1275085404442591232,,0,1,1,0,1,1,2,0.666667,0.75,0,5,0,0.020692
1100502233576337408,1100502233576337408,,0,1,1,0,1,1,2,0.666667,0.75,0,5,0,0.020692
1445090649825583104,1445090649825583104,,0,1,1,0,1,1,7,0.283203,0.300698,0,9,0,0.004809
2415755633,2415755633,,0,1,1,0,1,1,2,0.666667,0.75,0,5,0,0.020692
1360503757,1360503757,,0,2,2,0,2,2,2,0.666667,0.75,0,5,0,0.038617
1382995851275026432,1382995851275026432,,0,1,1,0,1,1,2,0.666667,0.75,0,5,0,0.020692
1294012105650249728,1294012105650249728,,0,1,1,0,1,1,2,0.666667,0.75,0,5,0,0.020692
488695183,488695183,,0,0,0,0,0,0,0,0,0,0,248,0,0
920285664037482496,920285664037482496,,0,1,1,0,1,1,2,0.666667,0.75,0,5,0,0.020692
1240110720429240320,1240110720429240320,,0,1,1,0,1,1,2,0.666667,0.75,0,5,0,0.020692
1485090944,1485090944,,0,1,1,0,1,1,2,0.666667,0.75,0,5,0,0.020692
458802038,458802038,,0,0,0,0,0,0,0,0,0,0,249,0,0
1124369551305658368,1124369551305658368,,0,1,1,0,1,1,2,0.666667,0.75,0,5,0,0.020692
785426151602790400,785426151602790400,,0,1,1,0,1,1,2,0.666667,0.75,0,5,0,0.020692
1399114548439826432,1399114548439826432,,0,1,1,0,1,1,2,0.666667,0.75,0,5,0,0.020692
583225151,583225151,,0,1,1,0,1,1,2,0.666667,0.75,0,5,0,0.020692
1347494296744833024,1347494296744833024,,0,1,1,0,1,1,7,0.283203,0.300698,0,9,0,0.004809
1318848066,1318848066,,0,2,2,0,2,2,2,0.75,0.833333,0,15,0,0.020728
1325550718422560768,1325550718422560768,,0,1,1,0,1,1,3,0.5,0.583333,0,5,0,0.000062
2359175635,2359175635,,0,1,1,0,1,1,2,0.666667,0.75,0,5,0,0.020692
2817204236,2817204236,,0,1,1,0,1,1,2,0.666667,0.75,0,5,0,0.020692
830753389,830753389,,0,1,1,0,1,1,2,0.666667,0.75,0,5,0,0.020692
1434606667962925056,1434606667962925056,,0,2,2,0,2,2,2,0.666667,0.75,0,5,0,0.038617
1009125592799875072,1009125592799875072,,0,5,5,0,10,10,2,0.692308,0.777778,0,250,0,0.000001
85852409,85852409,,1,0,1,2,0,2,0,0,0,0,250,0,0
58453980,58453980,,1,1,2,2,2,4,1,1,1,0,250,0,0
18680596,18680596,,1,0,1,2,0,2,0,0,0,0,250,0,0
401495840,401495840,,1,0,1,2,0,2,0,0,0,0,250,0,0
755795809568952320,755795809568952320,,0,0,0,0,0,0,0,0,0,0,251,0,0
95106953,95106953,,0,1,1,0,1,1,2,0.666667,0.75,0,5,0,0.020692
2337812391,2337812391,,0,1,1,0,1,1,2,0.666667,0.75,0,5,0,0.020692
1412791389272805376,1412791389272805376,,0,1,1,0,1,1,2,0.666667,0.75,0,5,0,0.020692
1417357309731295232,1417357309731295232,,0,1,1,0,1,1,2,0.666667,0.75,0,13,0,0.017924
1307218838673555456,1307218838673555456,,0,1,1,0,1,1,2,0.666667,0.75,0,5,0,0.020692
103068418,103068418,,0,0,0,0,0,0,0,0,0,0,252,0,0
1318802425239736320,1318802425239736320,,0,3,3,0,3,3,7,0.284736,0.305678,0,5,0,0.008499
1404850146358267904,1404850146358267904,,0,1,1,0,1,1,2,0.666667,0.75,0,5,0,0.020692
1301516130197090304,1301516130197090304,,0,0,0,0,0,0,0,0,0,0,253,0,0
497817902,497817902,,0,1,1,0,2,2,2,0.666667,0.75,0,13,0,0.017924
19485684,19485684,,0,1,1,0,1,1,3,0.5,0.583333,0,5,0,0.000062
223003331,223003331,,0,1,1,0,1,1,2,0.666667,0.75,0,5,0,0.020692
2196158901,2196158901,,0,1,1,0,1,1,2,0.666667,0.75,0,5,0,0.020692
2382659762,2382659762,,0,2,2,0,2,2,2,0.75,0.833333,0,21,0,0.01879
288223330,288223330,,0,3,3,0,3,3,4,0.492308,0.528646,0,14,0,0.021713
398082934,398082934,,2,0,2,2,0,2,0,0,0,0,14,0.000635,0
3012958347,3012958347,,0,1,1,0,1,1,1,1,1,0,254,0,0
956276568,956276568,,1,0,1,1,0,1,0,0,0,0,254,0,0
2772537010,2772537010,,0,0,0,0,0,0,0,0,0,0,255,0,0
1120279028156514304,1120279028156514304,,0,1,1,0,1,1,2,0.666667,0.75,0,5,0,0.020692
1043250043862614016,1043250043862614016,,0,1,1,0,1,1,7,0.283203,0.300698,0,9,0,0.004809
306496514,306496514,,0,1,1,0,1,1,2,0.666667,0.75,0,5,0,0.020692
2942674253,2942674253,,0,1,1,0,1,1,2,0.666667,0.75,0,5,0,0.020692
750670310,750670310,,0,3,3,0,5,5,3,0.470588,0.510417,0,28,0,0.000037
755266896,755266896,,0,1,1,0,1,1,3,0.5,0.583333,0,5,0,0.000062
1319609184858611712,1319609184858611712,,0,1,1,0,1,1,2,0.666667,0.75,0,5,0,0.020692
1268660844696657920,1268660844696657920,,0,1,1,0,1,1,2,0.666667,0.75,0,5,0,0.020692
1437754673834962944,1437754673834962944,,0,1,1,0,1,1,2,0.666667,0.75,0,5,0,0.020692
1289896008059686912,1289896008059686912,,0,1,1,0,1,1,2,0.666667,0.75,0,5,0,0.020692
1375179102383181824,1375179102383181824,,0,1,1,0,1,1,2,0.666667,0.75,0,5,0,0.020692
1433166899752341504,1433166899752341504,,0,1,1,0,1,1,2,0.666667,0.75,0,5,0,0.020692
1536148147,1536148147,,0,1,1,0,1,1,2,0.666667,0.75,0,5,0,0.020692
1430214893509218304,1430214893509218304,,0,1,1,0,1,1,2,0.666667,0.75,0,5,0,0.020692
1267403210,1267403210,,0,1,1,0,1,1,2,0.666667,0.75,0,5,0,0.020692
1363896657918775296,1363896657918775296,,0,1,1,0,1,1,2,0.666667,0.75,0,5,0,0.020692
1600575792,1600575792,,0,1,1,0,1,1,2,0.666667,0.75,0,5,0,0.020692
4788106457,4788106457,,0,3,3,0,3,3,6,0.4209,0.455115,0,14,0,0.00996
868961323190820864,868961323190820864,,0,1,1,0,1,1,2,0.666667,0.75,0,5,0,0.020692
928609924099248128,928609924099248128,,0,1,1,0,1,1,2,0.666667,0.75,0,5,0,0.020692
1358025352967303168,1358025352967303168,,0,1,1,0,1,1,2,0.666667,0.75,0,5,0,0.020692
1189828840769622016,1189828840769622016,,0,1,1,0,1,1,2,0.666667,0.75,0,5,0,0.020692
984090572687380480,984090572687380480,,0,2,2,0,2,2,2,0.75,0.833333,0,15,0,0.022161
721207033,721207033,,0,1,1,0,1,1,2,0.666667,0.75,0,5,0,0.020692
1229478864,1229478864,,0,3,3,0,3,3,2,0.714286,0.8,0,25,0,0.039237
766478352467263488,766478352467263488,,0,1,1,0,1,1,2,0.666667,0.75,0,5,0,0.020692
1420407232496349184,1420407232496349184,,0,1,1,0,1,1,2,0.666667,0.75,0,5,0,0.020692
587602246,587602246,,0,1,1,0,1,1,2,0.666667,0.75,0,5,0,0.020692
3120504428,3120504428,,0,1,1,0,1,1,2,0.666667,0.75,0,5,0,0.020692
1419022532913532928,1419022532913532928,,0,2,2,0,2,2,2,0.666667,0.75,0,5,0,0.038617
2833760769,2833760769,,0,1,1,0,1,1,1,1,1,0,28,0,0.000001
1409585182479376384,1409585182479376384,,0,1,1,0,1,1,2,0.666667,0.75,0,5,0,0.020692
2301384125,2301384125,,0,2,2,0,2,2,7,0.284457,0.30396,0,9,0,0.025501
959752759259131904,959752759259131904,,0,2,2,0,2,2,5,0.432099,0.465952,0,15,0,0.022282
59716246,59716246,,0,1,1,0,1,1,7,0.283203,0.300698,0,9,0,0.004809
2318991212,2318991212,,0,2,2,0,2,2,2,0.75,0.833333,0,5,0,0.020936
1137048670950645760,1137048670950645760,,0,1,1,0,1,1,7,0.283203,0.300698,0,9,0,0.004809
45815847,45815847,,0,1,1,0,1,1,2,0.666667,0.75,0,5,0,0.020692
1028713306444455936,1028713306444455936,,0,3,3,0,3,3,1,1,1,0,5,0,0.02438
914850145094774784,914850145094774784,,0,4,4,0,4,4,6,0.298611,0.371705,0,15,0,0.022568
2576093422,2576093422,,0,1,1,0,1,1,7,0.283203,0.300698,0,9,0,0.004809
318325648,318325648,,0,1,1,0,1,1,1,1,1,0,13,0,0.000584
224111514,224111514,,0,1,1,0,1,1,2,0.666667,0.75,0,5,0,0.020692
1419596108309929984,1419596108309929984,,0,1,1,0,2,2,3,0.428571,0.5,0,21,0,0.000033
4866617129,4866617129,,0,1,1,0,1,1,2,0.666667,0.75,0,5,0,0.020692
1450016941368823808,1450016941368823808,,0,0,0,0,0,0,0,0,0,0,256,0,0
1417770658499543040,1417770658499543040,,0,1,1,0,2,2,1,1,1,0,206,0,0.000018
488661862,488661862,,0,1,1,0,1,1,2,0.666667,0.75,0,5,0,0.020692
851521931312594944,851521931312594944,,0,1,1,0,1,1,2,0.666667,0.75,0,5,0,0.020692
515698229,515698229,,0,2,2,0,2,2,2,0.75,0.833333,0,15,0,0.019393
925709681594683392,925709681594683392,,0,1,1,0,1,1,2,0.666667,0.75,0,5,0,0.020692
1431181450959851520,1431181450959851520,,0,1,1,0,1,1,2,0.666667,0.75,0,5,0,0.020692
951524094792658944,951524094792658944,,0,1,1,0,1,1,2,0.666667,0.75,0,5,0,0.020692
1345062787102466048,1345062787102466048,,0,1,1,0,1,1,2,0.666667,0.75,0,5,0,0.020692
778517862457733120,778517862457733120,,0,1,1,0,1,1,2,0.666667,0.75,0,5,0,0.020692
581013965,581013965,,0,1,1,0,1,1,2,0.666667,0.75,0,5,0,0.020692
1238787162524594176,1238787162524594176,,0,1,1,0,1,1,2,0.666667,0.75,0,5,0,0.020692
1868840060,1868840060,,0,1,1,0,1,1,2,0.666667,0.75,0,5,0,0.020692
597716930,597716930,,0,1,1,0,1,1,2,0.666667,0.75,0,5,0,0.020692
465398233,465398233,,0,4,4,0,5,5,3,0.636364,0.761905,0,9,0,0.020746
421905037,421905037,,1,0,1,2,0,2,0,0,0,0,9,0.000606,0
1366060783529041920,1366060783529041920,,2,1,3,2,1,3,2,0.666667,0.75,0,9,0.000607,0.017924
396104852,396104852,,1,0,1,1,0,1,0,0,0,0,9,0.000606,0
1420799108466544640,1420799108466544640,,0,1,1,0,1,1,2,0.666667,0.75,0,5,0,0.020692
3234976656,3234976656,,0,1,1,0,1,1,2,0.666667,0.75,0,5,0,0.020692
2379986716,2379986716,,1,1,2,1,2,3,1,1,1,0.000003,15,0.001146,0
405482706,405482706,,1,2,3,1,2,3,1,1,1,0,15,0.001146,0.001748
1323328775086575616,1323328775086575616,,1,0,1,1,0,1,0,0,0,0,15,0.001146,0
358626243,358626243,,1,3,4,2,3,5,2,0.8,0.875,0,15,0.001146,0.001669
4000185035,4000185035,,1,0,1,1,0,1,0,0,0,0,15,0.001146,0
1427559614833385472,1427559614833385472,,1,0,1,1,0,1,0,0,0,0,15,0.001146,0
1449074288024334336,1449074288024334336,,1,0,1,1,0,1,0,0,0,0,15,0.001146,0
2345623510,2345623510,,0,1,1,0,1,1,2,0.666667,0.75,0,5,0,0.020692
1389470912,1389470912,,0,1,1,0,1,1,2,0.666667,0.75,0,5,0,0.020692
1050589128,1050589128,,0,3,3,0,3,3,1,1,1,0,28,0,0.000031
75099090,75099090,,0,1,1,0,1,1,2,0.666667,0.75,0,5,0,0.020692
1197281933690052608,1197281933690052608,,0,0,0,0,0,0,0,0,0,0,257,0,0
3080186967,3080186967,,0,5,5,0,5,5,2,0.777778,0.857143,0,15,0,0.041341
3358824147,3358824147,,0,0,0,0,0,0,0,0,0,0,258,0,0
3309862246,3309862246,,0,1,1,0,1,1,2,0.666667,0.75,0,5,0,0.020692
1154177835478781952,1154177835478781952,,0,1,1,0,1,1,2,0.666667,0.75,0,5,0,0.020692
1418318648704438272,1418318648704438272,,0,1,1,0,1,1,2,0.666667,0.75,0,5,0,0.020692
2497954053,2497954053,,0,0,0,0,0,0,0,0,0,0,259,0,0
1347233231180017664,1347233231180017664,,0,1,1,0,1,1,2,0.666667,0.75,0,5,0,0.020692
839535371348295680,839535371348295680,,0,0,0,0,0,0,0,0,0,0,260,0,0
1335634712069595136,1335634712069595136,,0,2,2,0,2,2,6,0.391363,0.431264,0,9,0,0.008958
1266725516536578048,1266725516536578048,,0,1,1,0,1,1,3,0.5,0.583333,0,5,0,0.000062
1159846091027709952,1159846091027709952,,0,1,1,0,1,1,2,0.666667,0.75,0,5,0,0.020692
607338233,607338233,,0,2,2,0,2,2,4,0.484375,0.513441,0,14,0,0.021694
821671876749619200,821671876749619200,,0,4,4,0,6,6,2,0.833333,0.9,0,13,0,0.022297
872840074425184256,872840074425184256,,0,3,3,0,3,3,2,0.666667,0.75,0,21,0,0.039565
1071434381028417536,1071434381028417536,,0,2,2,0,2,2,1,1,1,0,37,0,0.024137
2281770938,2281770938,,0,1,1,0,1,1,2,0.666667,0.75,0,5,0,0.020692
2395150745,2395150745,,0,1,1,0,1,1,2,0.6,0.666667,0,14,0,0.000018
2388934531,2388934531,,2,2,4,3,3,6,1,1,1,0.000006,14,0.000605,0
805837025723187200,805837025723187200,,0,1,1,0,1,1,2,0.666667,0.75,0,5,0,0.020692
1248575647255072768,1248575647255072768,,0,1,1,0,1,1,2,0.666667,0.75,0,5,0,0.020692
340294381,340294381,,0,1,1,0,1,1,2,0.666667,0.75,0,5,0,0.020692
478889514,478889514,,0,1,1,0,1,1,2,0.666667,0.75,0,5,0,0.020692
1321706399798382592,1321706399798382592,,0,1,1,0,1,1,2,0.666667,0.75,0,5,0,0.020692
1245392300194267136,1245392300194267136,,0,1,1,0,1,1,2,0.666667,0.75,0,5,0,0.020692
979254498886668288,979254498886668288,,0,1,1,0,1,1,2,0.666667,0.75,0,5,0,0.020692
948835548030033920,948835548030033920,,0,1,1,0,1,1,2,0.666667,0.75,0,5,0,0.020692
1277162157571018752,1277162157571018752,,0,1,1,0,1,1,2,0.666667,0.75,0,5,0,0.020692
272028995,272028995,,0,1,1,0,1,1,2,0.666667,0.75,0,5,0,0.020692
1419213655539912704,1419213655539912704,,0,2,2,0,2,2,1,1,1,0,37,0,0.024137
1356572433793351680,1356572433793351680,,0,3,3,0,3,3,7,0.284736,0.305678,0,37,0,0.028946
106220857,106220857,,0,2,2,0,3,3,2,0.75,0.833333,0,17,0,0.02073
1441668000101269504,1441668000101269504,,0,1,1,0,1,1,2,0.666667,0.75,0,5,0,0.020692
1143323226220765184,1143323226220765184,,0,1,1,0,1,1,2,0.666667,0.75,0,5,0,0.020692
1314188307417436160,1314188307417436160,,0,1,1,0,1,1,2,0.666667,0.75,0,5,0,0.020692
1309227547960508416,1309227547960508416,,0,1,1,0,1,1,2,0.666667,0.75,0,5,0,0.020692
840610379554279424,840610379554279424,,0,2,2,0,2,2,7,0.284457,0.30396,0,9,0,0.025501
213752633,213752633,,0,1,1,0,1,1,2,0.666667,0.75,0,5,0,0.020692
1444273475884101632,1444273475884101632,,0,1,1,0,1,1,2,0.666667,0.75,0,5,0,0.020692
2541537069,2541537069,,0,1,1,0,1,1,2,0.666667,0.75,0,13,0,0.017924
1326831348611493888,1326831348611493888,,0,2,2,0,2,2,2,0.75,0.833333,0,5,0,0.01817
1370085944112582656,1370085944112582656,,0,1,1,0,1,1,2,0.666667,0.75,0,5,0,0.020692
383772326,383772326,,0,1,1,0,1,1,2,0.666667,0.75,0,5,0,0.020692
918476256,918476256,,0,1,1,0,1,1,2,0.666667,0.75,0,5,0,0.020692
538233781,538233781,,0,1,1,0,1,1,2,0.666667,0.75,0,5,0,0.020692
2970015723,2970015723,,0,1,1,0,1,1,1,1,1,0,28,0,0
1338213606740144128,1338213606740144128,,0,1,1,0,1,1,2,0.666667,0.75,0,5,0,0.020692
781757617567694848,781757617567694848,,0,1,1,0,1,1,2,0.666667,0.75,0,5,0,0.020692
867330310433898496,867330310433898496,,0,1,1,0,1,1,2,0.666667,0.75,0,5,0,0.020692
861090048476839936,861090048476839936,,0,1,1,0,1,1,2,0.666667,0.75,0,5,0,0.020692
961833858097332224,961833858097332224,,0,1,1,0,1,1,2,0.666667,0.75,0,5,0,0.020692
1009068139,1009068139,,0,1,1,0,1,1,2,0.666667,0.75,0,5,0,0.020692
1316031520897937408,1316031520897937408,,0,1,1,0,1,1,2,0.666667,0.75,0,5,0,0.020692
957705748665991168,957705748665991168,,0,1,1,0,1,1,2,0.666667,0.75,0,5,0,0.020692
719436488094650368,719436488094650368,,0,1,1,0,1,1,2,0.666667,0.75,0,5,0,0.020692
788384260512182272,788384260512182272,,0,2,2,0,3,3,2,0.666667,0.75,0,13,0,0.038617
2750255094,2750255094,,0,1,1,0,1,1,2,0.666667,0.75,0,5,0,0.020692
1148228227,1148228227,,0,1,1,0,1,1,2,0.666667,0.75,0,5,0,0.020692
2743207284,2743207284,,0,1,1,0,1,1,2,0.666667,0.75,0,5,0,0.020692
434394574,434394574,,0,1,1,0,1,1,2,0.666667,0.75,0,5,0,0.020692
478092818,478092818,,0,1,1,0,1,1,7,0.283203,0.300698,0,9,0,0.004809
1339923900801708032,1339923900801708032,,0,1,1,0,1,1,2,0.666667,0.75,0,5,0,0.020692
1440334547573362688,1440334547573362688,,0,1,1,0,1,1,2,0.666667,0.75,0,5,0,0.020692
950438952288374784,950438952288374784,,0,1,1,0,1,1,1,1,1,0,261,0,0
96548934,96548934,,1,0,1,1,0,1,0,0,0,0,261,0,0
1158716606723317760,1158716606723317760,,0,2,2,0,3,3,2,0.75,0.833333,0,5,0,0.020728
2417454271,2417454271,,0,2,2,0,2,2,2,0.666667,0.75,0,5,0,0.038617
1198145310163439616,1198145310163439616,,0,1,1,0,1,1,2,0.666667,0.75,0,5,0,0.020692
1305742837,1305742837,,0,3,3,0,3,3,2,0.8,0.875,0,5,0,0.020728
2826931643,2826931643,,2,0,2,2,0,2,0,0,0,0,5,0.000606,0
1400344739115851776,1400344739115851776,,2,0,2,2,0,2,0,0,0,0,5,0.000606,0
89930300,89930300,,0,2,2,0,2,2,2,0.666667,0.75,0,5,0,0.038617
1087849336241905664,1087849336241905664,,0,1,1,0,2,2,2,0.666667,0.75,0,13,0,0.017924
375761094,375761094,,0,1,1,0,1,1,2,0.666667,0.75,0,5,0,0.020692
755442242,755442242,,0,1,1,0,1,1,2,0.666667,0.75,0,5,0,0.020692
1418225201167310848,1418225201167310848,,0,1,1,0,1,1,2,0.666667,0.75,0,5,0,0.020692
1195820682145341440,1195820682145341440,,0,1,1,0,1,1,2,0.666667,0.75,0,5,0,0.020692
1422223616310185984,1422223616310185984,,1,0,1,2,0,2,0,0,0,0,13,0.001129,0
2351644802,2351644802,,0,1,1,0,1,1,2,0.666667,0.75,0,5,0,0.020692
1076836690625466368,1076836690625466368,,0,5,5,0,5,5,5,0.433155,0.477778,0,15,0,0.024134
1125080944187195392,1125080944187195392,,0,1,1,0,1,1,2,0.666667,0.75,0,5,0,0.020692
399469627,399469627,,0,1,1,0,1,1,2,0.666667,0.75,0,5,0,0.020692
1309891743932911616,1309891743932911616,,0,1,1,0,1,1,2,0.666667,0.75,0,5,0,0.020692
533019074,533019074,,0,2,2,0,2,2,7,0.283757,0.302997,0,9,0,0.022733
1163011455584747520,1163011455584747520,,0,3,3,0,4,4,2,0.8,0.875,0,14,0,0.019717
453851050,453851050,,0,1,1,0,1,1,2,0.666667,0.75,0,5,0,0.020692
1417845132964007936,1417845132964007936,,0,1,1,0,1,1,2,0.666667,0.75,0,5,0,0.020692
1417507344,1417507344,,0,1,1,0,1,1,2,0.666667,0.75,0,5,0,0.020692
79963123,79963123,,0,2,2,0,3,3,2,0.75,0.833333,0,5,0,0.020757
975658764752781312,975658764752781312,,0,1,1,0,1,1,2,0.666667,0.75,0,5,0,0.020692
1428957043440832512,1428957043440832512,,0,1,1,0,1,1,2,0.666667,0.75,0,5,0,0.020692
521450521,521450521,,0,0,0,0,0,0,0,0,0,0,262,0,0
3255952955,3255952955,,0,2,2,0,3,3,2,0.75,0.833333,0,5,0,0.02071
1428732356022652928,1428732356022652928,,1,0,1,2,0,2,0,0,0,0,5,0.000605,0
1465510008,1465510008,,0,1,1,0,1,1,2,0.666667,0.75,0,5,0,0.020692
792375937702723584,792375937702723584,,0,1,1,0,1,1,2,0.666667,0.75,0,5,0,0.020692
246840871,246840871,,0,1,1,0,1,1,2,0.666667,0.75,0,5,0,0.020692
719147371045765120,719147371045765120,,0,1,1,0,1,1,2,0.666667,0.75,0,5,0,0.020692
1228058216,1228058216,,0,1,1,0,1,1,7,0.283203,0.300698,0,9,0,0.004809
3293321535,3293321535,,0,1,1,0,1,1,2,0.666667,0.75,0,13,0,0.017924
1422201492434522112,1422201492434522112,,0,1,1,0,1,1,2,0.666667,0.75,0,5,0,0.020692
1124332272419790848,1124332272419790848,,0,1,1,0,1,1,2,0.666667,0.75,0,5,0,0.020692
3402764877,3402764877,,0,1,1,0,1,1,2,0.666667,0.75,0,5,0,0.020692
2987083593,2987083593,,0,1,1,0,1,1,2,0.666667,0.75,0,5,0,0.020692
2269285706,2269285706,,0,1,1,0,1,1,2,0.666667,0.75,0,5,0,0.020692
1172727273566457856,1172727273566457856,,0,1,1,0,1,1,2,0.666667,0.75,0,5,0,0.020692
1441838934514810880,1441838934514810880,,0,2,2,0,2,2,2,0.75,0.833333,0,37,0,0.020797
1001876772105932800,1001876772105932800,,0,2,2,0,2,2,2,0.666667,0.75,0,5,0,0.038617
470382655,470382655,,0,1,1,0,1,1,2,0.666667,0.75,0,5,0,0.020692
312496137,312496137,,0,1,1,0,1,1,2,0.666667,0.75,0,5,0,0.020692
96576495,96576495,,0,1,1,0,1,1,1,1,1,0,5,0,0.000237
1444983431574790144,1444983431574790144,,0,1,1,0,1,1,2,0.666667,0.75,0,5,0,0.020692
1419574524367056896,1419574524367056896,,0,1,1,0,1,1,2,0.666667,0.75,0,5,0,0.020692
4147861697,4147861697,,0,1,1,0,1,1,2,0.666667,0.75,0,5,0,0.020692
458169759,458169759,,0,2,2,0,2,2,3,0.52381,0.575758,0,15,0,0.020721
919613309464338432,919613309464338432,,0,1,1,0,1,1,2,0.666667,0.75,0,5,0,0.020692
1153432106124697600,1153432106124697600,,0,2,2,0,2,2,2,0.666667,0.75,0,5,0,0.038617
829051873277644800,829051873277644800,,0,1,1,0,1,1,2,0.666667,0.75,0,5,0,0.020692
1239873644588908544,1239873644588908544,,0,1,1,0,1,1,2,0.666667,0.75,0,5,0,0.020692
1420281535257845760,1420281535257845760,,0,1,1,0,1,1,2,0.666667,0.75,0,5,0,0.020692
1593270115,1593270115,,0,1,1,0,1,1,2,0.666667,0.75,0,5,0,0.020692
577628205,577628205,,0,1,1,0,1,1,2,0.666667,0.75,0,5,0,0.020692
2446945421,2446945421,,0,3,3,0,3,3,3,0.555556,0.633333,0,15,0,0.039048
1002129280938205184,1002129280938205184,,0,2,2,0,2,2,7,0.284457,0.30396,0,9,0,0.025501
1134742620801028096,1134742620801028096,,0,1,1,0,1,1,2,0.666667,0.75,0,5,0,0.020692
89733800,89733800,,0,1,1,0,1,1,2,0.666667,0.75,0,5,0,0.020692
1121007620247175168,1121007620247175168,,0,0,0,0,0,0,0,0,0,0,263,0,0
457549220,457549220,,0,1,1,0,1,1,1,1,1,0,28,0,0
1273686762691297280,1273686762691297280,,0,3,3,0,3,3,2,0.8,0.875,0,37,0,0.042061
158288741,158288741,,0,2,2,0,2,2,2,0.75,0.833333,0,9,0,0.021001
456848255,456848255,,0,0,0,0,0,0,0,0,0,0,264,0,0
394780039,394780039,,0,1,1,0,1,1,2,0.666667,0.75,0,5,0,0.020692
1423744944544550912,1423744944544550912,,0,1,1,0,1,1,2,0.666667,0.75,0,5,0,0.020692
2954986355,2954986355,,0,1,1,0,1,1,2,0.666667,0.75,0,5,0,0.020692
1038536159478120448,1038536159478120448,,0,0,0,0,0,0,0,0,0,0,265,0,0
1010838208974917632,1010838208974917632,,0,2,2,0,2,2,5,0.432099,0.465952,0,15,0,0.022282
767331211,767331211,,0,2,2,0,2,2,2,0.75,0.833333,0,13,0,0.017975
1326240673281028096,1326240673281028096,,0,1,1,0,1,1,2,0.666667,0.75,0,5,0,0.020692
1479225242,1479225242,,0,1,1,0,1,1,2,0.666667,0.75,0,5,0,0.020692
892325997437231104,892325997437231104,,0,1,1,0,1,1,2,0.666667,0.75,0,5,0,0.020692
3191764757,3191764757,,0,1,1,0,1,1,2,0.666667,0.75,0,5,0,0.020692
245969509,245969509,,0,2,2,0,2,2,2,0.666667,0.75,0,5,0,0.038617
901024096330371072,901024096330371072,,0,1,1,0,1,1,2,0.666667,0.75,0,5,0,0.020692
425981781,425981781,,0,2,2,0,2,2,2,0.666667,0.75,0,21,0,0.021641
1895353393,1895353393,,0,3,3,0,3,3,7,0.284593,0.305583,0,37,0,0.026178
16460394,16460394,,0,0,0,0,0,0,0,0,0,0,266,0,0
1516149242,1516149242,,2,0,2,2,0,2,0,0,0,0,13,0.001665,0
1123860757140131840,1123860757140131840,,0,1,1,0,1,1,2,0.666667,0.75,0,5,0,0.020692
446512007,446512007,,0,1,1,0,1,1,2,0.666667,0.75,0,5,0,0.020692
1252343261064310784,1252343261064310784,,0,1,1,0,1,1,7,0.283203,0.300698,0,9,0,0.004809
445474658,445474658,,0,1,1,0,1,1,2,0.666667,0.75,0,5,0,0.020692
761199432,761199432,,0,1,1,0,1,1,2,0.666667,0.75,0,5,0,0.020692
1334218464643457024,1334218464643457024,,0,1,1,0,1,1,2,0.666667,0.75,0,5,0,0.020692
387745397,387745397,,0,4,4,0,4,4,6,0.39369,0.436353,0,9,0,0.043709
1403942882961207296,1403942882961207296,,0,1,1,0,1,1,2,0.666667,0.75,0,13,0,0.017924
1396159797175726080,1396159797175726080,,0,1,1,0,1,1,2,0.666667,0.75,0,5,0,0.020692
1431246714002944000,1431246714002944000,,0,0,0,0,0,0,0,0,0,0,267,0,0
840203779,840203779,,0,1,1,0,1,1,7,0.283203,0.300698,0,9,0,0.004809
24366244,24366244,,1,0,1,1,0,1,0,0,0,0,5,0.000607,0
1154663621617737728,1154663621617737728,,1,0,1,1,0,1,0,0,0,0,5,0.000607,0
107019869,107019869,,1,1,2,1,1,2,1,1,1,0.000001,5,0.000607,0.000018
1443868124659466240,1443868124659466240,,1,2,3,1,3,4,2,0.75,0.833333,0,5,0.000607,0.02093
826103424173359104,826103424173359104,,0,1,1,0,1,1,2,0.666667,0.75,0,5,0,0.020692
1248505220948094976,1248505220948094976,,0,1,1,0,1,1,2,0.666667,0.75,0,5,0,0.020692
1156098031651102720,1156098031651102720,,0,0,0,0,0,0,0,0,0,0,268,0,0
2644846049,2644846049,,1,0,1,2,0,2,0,0,0,0,13,0.001129,0
1434161609102987264,1434161609102987264,,0,1,1,0,1,1,2,0.666667,0.75,0,5,0,0.020692
720298583296061440,720298583296061440,,0,2,2,0,2,2,2,0.75,0.833333,0,5,0,0.02093
702450937395351552,702450937395351552,,0,2,2,0,2,2,6,0.391363,0.431264,0,9,0,0.008958
2311520868,2311520868,,0,1,1,0,1,1,2,0.666667,0.75,0,5,0,0.020692
1405933417116667904,1405933417116667904,,0,1,1,0,1,1,2,0.666667,0.75,0,5,0,0.020692
1352310909272731648,1352310909272731648,,0,1,1,0,1,1,2,0.666667,0.75,0,5,0,0.020692
358968766,358968766,,0,2,2,0,2,2,2,0.666667,0.75,0,5,0,0.038617
427611913,427611913,,0,1,1,0,1,1,2,0.666667,0.75,0,5,0,0.020692
1242430802576781312,1242430802576781312,,0,1,1,0,1,1,2,0.666667,0.75,0,13,0,0.017924
1035665769651204096,1035665769651204096,,0,1,1,0,1,1,2,0.666667,0.75,0,5,0,0.020692
1477983924,1477983924,,0,1,1,0,1,1,2,0.666667,0.75,0,5,0,0.020692
303138242,303138242,,0,1,1,0,1,1,2,0.666667,0.75,0,5,0,0.020692
301717777,301717777,,0,1,1,0,1,1,1,1,1,0,13,0,0.000584
1418612969076936704,1418612969076936704,,0,1,1,0,1,1,2,0.666667,0.75,0,5,0,0.020692
2731131760,2731131760,,0,3,3,0,3,3,2,0.666667,0.75,0,15,0,0.021173
1606847226,1606847226,,0,1,1,0,1,1,1,1,1,0,13,0,0.000051
1234660638,1234660638,,0,1,1,0,1,1,2,0.666667,0.75,0,5,0,0.020692
1430837431566278656,1430837431566278656,,0,3,3,0,3,3,2,0.714286,0.8,0,13,0,0.038717
161624161,161624161,,0,1,1,0,1,1,1,1,1,0,9,0,0.000943
1171897332474007552,1171897332474007552,,0,1,1,0,1,1,2,0.666667,0.75,0,5,0,0.020692
906974985151041536,906974985151041536,,0,1,1,0,1,1,7,0.283203,0.300698,0,9,0,0.004809
1417944920971677696,1417944920971677696,,0,1,1,0,1,1,2,0.666667,0.75,0,5,0,0.020692
2348240124,2348240124,,0,1,1,0,1,1,2,0.666667,0.75,0,5,0,0.020692
1420870472,1420870472,,0,1,1,0,1,1,2,0.666667,0.75,0,5,0,0.020692
1421904621593927680,1421904621593927680,,0,2,2,0,2,2,7,0.284035,0.303284,0,14,0,0.006322
1355084532643475456,1355084532643475456,,0,1,1,0,1,1,2,0.666667,0.75,0,5,0,0.020692
3319225489,3319225489,,0,1,1,0,1,1,2,0.666667,0.75,0,5,0,0.020692
2757625763,2757625763,,0,4,4,0,4,4,2,0.75,0.833333,0,13,0,0.020393
1448042555871055872,1448042555871055872,,0,1,1,0,1,1,2,0.666667,0.75,0,5,0,0.020692
1381992439175593984,1381992439175593984,,0,2,2,0,2,2,5,0.432099,0.465952,0,15,0,0.022282
1160071044490846208,1160071044490846208,,0,2,2,0,2,2,7,0.284457,0.30396,0,9,0,0.025501
1098441957775425536,1098441957775425536,,0,1,1,0,1,1,2,0.666667,0.75,0,5,0,0.020692
1445831120742871040,1445831120742871040,,0,1,1,0,1,1,1,1,1,0,13,0,0.000051
4074792743,4074792743,,0,1,1,0,1,1,2,0.666667,0.75,0,5,0,0.020692
3698673454,3698673454,,0,0,0,0,0,0,0,0,0,0,269,0,0
1450049657212702720,1450049657212702720,,0,1,1,0,1,1,3,0.5,0.583333,0,5,0,0.000062
415619638,415619638,,0,1,1,0,1,1,2,0.666667,0.75,0,5,0,0.020692
1429756717236097024,1429756717236097024,,0,2,2,0,2,2,2,0.75,0.833333,0,25,0,0.021313
2511809006,2511809006,,0,1,1,0,1,1,2,0.666667,0.75,0,5,0,0.020692
1198007136,1198007136,,0,1,1,0,1,1,2,0.666667,0.75,0,5,0,0.020692
1014516143586009088,1014516143586009088,,0,2,2,0,2,2,2,0.75,0.833333,0,5,0,0.02071
1244917670241357824,1244917670241357824,,2,0,2,2,0,2,0,0,0,0,5,0.000605,0
1251142364879441920,1251142364879441920,,0,2,2,0,2,2,2,0.666667,0.75,0,5,0,0.038617
1184793498027003904,1184793498027003904,,0,1,1,0,1,1,2,0.666667,0.75,0,5,0,0.020692
1401451074029039616,1401451074029039616,,0,1,1,0,1,1,2,0.666667,0.75,0,5,0,0.020692
1006529804315889664,1006529804315889664,,0,1,1,0,1,1,2,0.666667,0.75,0,5,0,0.020692
1198015322839830528,1198015322839830528,,0,3,3,0,4,4,3,0.512821,0.558333,0,13,0,0.038887
1163172309781426176,1163172309781426176,,0,1,1,0,1,1,2,0.666667,0.75,0,5,0,0.020692
1031432488294461440,1031432488294461440,,0,1,1,0,1,1,2,0.666667,0.75,0,5,0,0.020692
1197129568697700352,1197129568697700352,,0,0,0,0,0,0,0,0,0,0,270,0,0
1387010082265780224,1387010082265780224,,0,1,1,0,1,1,2,0.666667,0.75,0,5,0,0.020692
948007465773395968,948007465773395968,,0,1,1,0,1,1,2,0.666667,0.75,0,5,0,0.020692
825484429,825484429,,2,0,2,3,0,3,0,0,0,0,14,0.000524,0
1295001682850525184,1295001682850525184,,0,2,2,0,2,2,2,0.666667,0.75,0,5,0,0.038617
910760879242858496,910760879242858496,,0,1,1,0,1,1,2,0.666667,0.75,0,5,0,0.020692
797083645878169600,797083645878169600,,0,2,2,0,2,2,2,0.666667,0.75,0,5,0,0.038617
1426437286015770624,1426437286015770624,,0,1,1,0,1,1,2,0.666667,0.75,0,5,0,0.020692
2412997944,2412997944,,0,1,1,0,1,1,2,0.666667,0.75,0,5,0,0.020692
1443527425510490112,1443527425510490112,,1,0,1,2,0,2,0,0,0,0,110,0,0
529210479,529210479,,1,0,1,2,0,2,0,0,0,0,110,0,0
871931652,871931652,,1,0,1,2,0,2,0,0,0,0,110,0,0
500041174,500041174,,1,0,1,2,0,2,0,0,0,0,110,0,0
815668386151759872,815668386151759872,,0,1,1,0,1,1,2,0.666667,0.75,0,13,0,0.017924
968518778811281408,968518778811281408,,0,2,2,0,2,2,6,0.391781,0.432051,0,9,0,0.024842
115756924,115756924,,0,1,1,0,1,1,2,0.666667,0.75,0,5,0,0.020692
1177798368,1177798368,,0,1,1,0,1,1,2,0.666667,0.75,0,5,0,0.020692
1249408332953030656,1249408332953030656,,0,1,1,0,1,1,2,0.666667,0.75,0,5,0,0.020692
500711588,500711588,,2,0,2,3,0,3,0,0,0,0,17,0.000569,0
1255459757730775040,1255459757730775040,,0,2,2,0,2,2,2,0.666667,0.75,0,5,0,0.038617
971790162740043776,971790162740043776,,0,1,1,0,1,1,3,0.5,0.583333,0,5,0,0.000062
2663921790,2663921790,,0,2,2,0,2,2,2,0.75,0.833333,0,9,0,0.021635
396878090,396878090,,0,1,1,0,1,1,2,0.666667,0.75,0,5,0,0.020692
1328978233249902592,1328978233249902592,,0,1,1,0,1,1,2,0.666667,0.75,0,13,0,0.017924
1434260351634268160,1434260351634268160,,0,1,1,0,1,1,7,0.283203,0.300698,0,9,0,0.004809
889221587727265792,889221587727265792,,0,2,2,0,2,2,1,1,1,0,37,0,0.024137
825815605,825815605,,0,1,1,0,1,1,2,0.666667,0.75,0,5,0,0.020692
826765603558023168,826765603558023168,,0,1,1,0,1,1,2,0.666667,0.75,0,5,0,0.020692
1239486956,1239486956,,0,1,1,0,1,1,1,1,1,0,5,0,0.000237
880354010,880354010,,0,1,1,0,1,1,2,0.666667,0.75,0,5,0,0.020692
705170019769065472,705170019769065472,,0,2,2,0,2,2,2,0.75,0.833333,0,15,0,0.022161
3823452387,3823452387,,0,0,0,0,0,0,0,0,0,0,271,0,0
324291796,324291796,,0,1,1,0,1,1,2,0.666667,0.75,0,5,0,0.020692
2350440677,2350440677,,0,2,2,0,2,2,2,0.666667,0.75,0,5,0,0.038617
541099811,541099811,,0,1,1,0,1,1,2,0.666667,0.75,0,5,0,0.020692
1027112602751643648,1027112602751643648,,0,1,1,0,1,1,2,0.666667,0.75,0,5,0,0.020692
1401847828708724736,1401847828708724736,,0,1,1,0,1,1,2,0.666667,0.75,0,5,0,0.020692
2685937596,2685937596,,0,1,1,0,1,1,2,0.666667,0.75,0,13,0,0.017924
353678923,353678923,,0,1,1,0,1,1,2,0.666667,0.75,0,5,0,0.020692
350332540,350332540,,0,2,2,0,2,2,6,0.391781,0.432051,0,9,0,0.024842
1296390431190679552,1296390431190679552,,0,1,1,0,1,1,2,0.666667,0.75,0,5,0,0.020692
494853735,494853735,,0,0,0,0,0,0,0,0,0,0,272,0,0
1236660855120498688,1236660855120498688,,0,3,3,0,3,3,2,0.8,0.875,0,25,0,0.021331
950850012304543744,950850012304543744,,2,0,2,2,0,2,0,0,0,0,25,0.000624,0
1291064679792549888,1291064679792549888,,0,2,2,0,2,2,2,0.666667,0.75,0,5,0,0.038617
1445087880578281472,1445087880578281472,,0,2,2,0,3,3,2,0.666667,0.75,0,13,0,0.038617
708025852,708025852,,0,3,3,0,3,3,6,0.392857,0.434382,0,9,0,0.024882
1278520868,1278520868,,2,1,3,2,1,3,1,1,1,0.000018,9,0.001357,0
2361317193,2361317193,,0,1,1,0,1,1,2,0.666667,0.75,0,5,0,0.020692
368333719,368333719,,0,1,1,0,1,1,2,0.666667,0.75,0,5,0,0.020692
587258432,587258432,,0,1,1,0,1,1,2,0.666667,0.75,0,5,0,0.020692
1311420488,1311420488,,0,3,3,0,3,3,6,0.393775,0.434937,0,15,0,0.025273
1254406260142813184,1254406260142813184,,0,1,1,0,1,1,2,0.666667,0.75,0,5,0,0.020692
1165612918458769408,1165612918458769408,,0,1,1,0,1,1,2,0.666667,0.75,0,5,0,0.020692
1168582180781604864,1168582180781604864,,0,1,1,0,1,1,2,0.666667,0.75,0,5,0,0.020692
898634999121027072,898634999121027072,,0,1,1,0,1,1,1,1,1,0,14,0,0
705344611,705344611,,2,0,2,3,0,3,0,0,0,0,14,0,0
245484212,245484212,,0,2,2,0,2,2,2,0.75,0.833333,0,5,0,0.020754
22931464,22931464,,0,1,1,0,1,1,2,0.666667,0.75,0,5,0,0.020692
426152264,426152264,,0,1,1,0,1,1,2,0.666667,0.75,0,304,0,0.000024
338426064,338426064,,1,0,1,2,0,2,0,0,0,0,5,0.000605,0
1267598313215459328,1267598313215459328,,0,1,1,0,1,1,2,0.666667,0.75,0,5,0,0.020692
1181573622588231680,1181573622588231680,,0,1,1,0,1,1,2,0.666667,0.75,0,5,0,0.020692
943551660651089920,943551660651089920,,0,1,1,0,1,1,2,0.666667,0.75,0,5,0,0.020692
432073381,432073381,,0,1,1,0,1,1,2,0.666667,0.75,0,5,0,0.020692
1239564980460179456,1239564980460179456,,0,1,1,0,1,1,2,0.666667,0.75,0,5,0,0.020692
1408102610347888640,1408102610347888640,,0,1,1,0,1,1,2,0.666667,0.75,0,5,0,0.020692
1349330625803771904,1349330625803771904,,0,1,1,0,1,1,2,0.666667,0.75,0,5,0,0.020692
806305806,806305806,,0,2,2,0,3,3,4,0.484375,0.513441,0,14,0,0.021694
1201070773697429504,1201070773697429504,,0,1,1,0,1,1,2,0.666667,0.75,0,5,0,0.020692
306208588,306208588,,0,1,1,0,1,1,2,0.666667,0.75,0,5,0,0.020692
513790402,513790402,,0,1,1,0,1,1,2,0.666667,0.75,0,5,0,0.020692
1219329455115657216,1219329455115657216,,0,1,1,0,1,1,2,0.666667,0.75,0,5,0,0.020692
92796550,92796550,,0,1,1,0,1,1,2,0.666667,0.75,0,5,0,0.020692
902435333559738368,902435333559738368,,0,1,1,0,1,1,2,0.666667,0.75,0,5,0,0.020692
193838010,193838010,,0,0,0,0,0,0,0,0,0,0,273,0,0
1393746926542131200,1393746926542131200,,0,2,2,0,2,2,2,0.75,0.833333,0,5,0,0.02071
1238573430510936064,1238573430510936064,,1,0,1,1,0,1,0,0,0,0,5,0.000605,0
1410304718954434560,1410304718954434560,,0,3,3,0,4,4,2,0.714286,0.8,0,13,0,0.038854
732819391,732819391,,3,0,3,4,0,4,0,0,0,0,304,0,0
1143175728046977024,1143175728046977024,,0,1,1,0,1,1,2,0.666667,0.75,0,5,0,0.020692
391997780,391997780,,0,2,2,0,2,2,2,0.75,0.833333,0,5,0,0.02093
59416763,59416763,,0,1,1,0,1,1,2,0.666667,0.75,0,5,0,0.020692
4213226247,4213226247,,0,1,1,0,1,1,7,0.283203,0.300698,0,9,0,0.004809
1323275967096303616,1323275967096303616,,0,1,1,0,1,1,2,0.666667,0.75,0,5,0,0.020692
1410514975286829056,1410514975286829056,,0,1,1,0,1,1,2,0.666667,0.75,0,5,0,0.020692
73452714,73452714,,0,1,1,0,1,1,2,0.666667,0.75,0,5,0,0.020692
53074807,53074807,,0,1,1,0,1,1,2,0.666667,0.75,0,5,0,0.020692
1285705967057993728,1285705967057993728,,0,1,1,0,1,1,2,0.666667,0.75,0,5,0,0.020692
904782497082478592,904782497082478592,,0,1,1,0,1,1,7,0.283203,0.300698,0,9,0,0.004809
1140637996036820992,1140637996036820992,,0,1,1,0,1,1,2,0.666667,0.75,0,5,0,0.020692
2345272376,2345272376,,0,3,3,0,5,5,1,1,1,0,274,0,0
2804109824,2804109824,,1,0,1,2,0,2,0,0,0,0,274,0,0
1255023281624801280,1255023281624801280,,1,0,1,2,0,2,0,0,0,0,274,0,0
4611199415,4611199415,,1,0,1,1,0,1,0,0,0,0,274,0,0
1426459620235792384,1426459620235792384,,0,0,0,0,0,0,0,0,0,0,275,0,0
1404139858814287872,1404139858814287872,,0,1,1,0,1,1,7,0.283203,0.300698,0,9,0,0.004809
518821897,518821897,,0,1,1,0,1,1,2,0.666667,0.75,0,5,0,0.020692
1247251507789074432,1247251507789074432,,0,1,1,0,1,1,7,0.283203,0.300698,0,9,0,0.004809
1445083793702981632,1445083793702981632,,0,1,1,0,1,1,7,0.283203,0.300698,0,9,0,0.004809
231568474,231568474,,0,1,1,0,1,1,7,0.283203,0.300698,0,9,0,0.004809
2889112334,2889112334,,0,1,1,0,1,1,7,0.283203,0.300698,0,9,0,0.004809
1289510747152822272,1289510747152822272,,0,1,1,0,1,1,7,0.283203,0.300698,0,9,0,0.004809
877570096302051328,877570096302051328,,0,0,0,0,0,0,0,0,0,0,276,0,0
1346931942,1346931942,,0,1,1,0,1,1,7,0.283203,0.300698,0,9,0,0.004809
1265052798,1265052798,,0,1,1,0,1,1,1,1,1,0,13,0,0.000102
1372328581553065984,1372328581553065984,,0,1,1,0,1,1,2,0.666667,0.75,0,5,0,0.020692
43578146,43578146,,0,2,2,0,2,2,6,0.391363,0.431264,0,9,0,0.008958
426112917,426112917,,0,2,2,0,2,2,1,1,1,0,9,0,0.000328
161617972,161617972,,0,0,0,0,0,0,0,0,0,0,277,0,0
1332305305456308224,1332305305456308224,,0,1,1,0,1,1,1,1,1,0,207,0,0
2936616287,2936616287,,0,0,0,0,0,0,0,0,0,0,278,0,0
1142544021283381248,1142544021283381248,,0,0,0,0,0,0,0,0,0,0,279,0,0
346800458,346800458,,0,2,2,0,2,2,6,0.391245,0.431469,0,13,0,0.004252
3410017097,3410017097,,0,1,1,0,2,2,2,0.666667,0.75,0,13,0,0.017924
1445115166815830016,1445115166815830016,,0,0,0,0,0,0,0,0,0,0,280,0,0
3729794056,3729794056,,0,1,1,0,2,2,2,0.666667,0.75,0,13,0,0.017924
2832197470,2832197470,,1,0,1,1,0,1,0,0,0,0,13,0,0
1416887046635937792,1416887046635937792,,0,1,1,0,1,1,7,0.283203,0.300698,0,9,0,0.004809
477897185,477897185,,0,3,3,0,4,4,5,0.451613,0.47483,0,28,0,0.000076
862919533929123840,862919533929123840,,0,1,1,0,1,1,1,1,1,0,13,0,0.000584
404145376,404145376,,0,1,1,0,1,1,1,1,1,0,13,0,0.000102
1391525097010302976,1391525097010302976,,0,2,2,0,2,2,1,1,1,0,13,0,0.000193
1448438894454878208,1448438894454878208,,0,1,1,0,1,1,2,0.666667,0.75,0,5,0,0.020692
443821474,443821474,,0,1,1,0,1,1,7,0.283203,0.300698,0,9,0,0.004809
445069408,445069408,,0,4,4,0,5,5,7,0.306931,0.33813,0,15,0,0.006794
2881990098,2881990098,,1,0,1,1,0,1,0,0,0,0,15,0.000198,0
3068577610,3068577610,,0,1,1,0,1,1,1,1,1,0,169,0,0
69968672,69968672,,0,1,1,0,1,1,7,0.283203,0.300698,0,9,0,0.004809
1030140920593833984,1030140920593833984,,0,1,1,0,1,1,7,0.283203,0.300698,0,9,0,0.004809
2562066140,2562066140,,0,1,1,0,1,1,2,0.666667,0.75,0,5,0,0.020692
1008445542,1008445542,,1,0,1,1,0,1,0,0,0,0,13,0.000665,0
128855697,128855697,,0,1,1,0,1,1,7,0.283203,0.300698,0,9,0,0.004809
1414534768109277184,1414534768109277184,,0,2,2,0,2,2,2,0.666667,0.75,0,5,0,0.038617
752255117232054272,752255117232054272,,0,1,1,0,1,1,7,0.283203,0.300698,0,9,0,0.004809
3151692490,3151692490,,0,1,1,0,1,1,2,0.666667,0.75,0,13,0,0.017924
1349274793615486976,1349274793615486976,,0,1,1,0,1,1,2,0.666667,0.75,0,13,0,0.017924
1393851835,1393851835,,0,1,1,0,1,1,7,0.283203,0.300698,0,9,0,0.004809
38846888,38846888,,0,0,0,0,0,0,0,0,0,0,281,0,0
790812939439771648,790812939439771648,,0,1,1,0,1,1,7,0.283203,0.300698,0,9,0,0.004809
701776676,701776676,,0,1,1,0,1,1,7,0.283203,0.300698,0,9,0,0.004809
560086917,560086917,,0,2,2,0,2,2,7,0.284593,0.304146,0,21,0,0.005757
1210563073355980800,1210563073355980800,,0,1,1,0,1,1,7,0.283203,0.300698,0,9,0,0.004809
1450069239809941504,1450069239809941504,,0,1,1,0,1,1,2,0.666667,0.75,0,5,0,0.020692
141521806,141521806,,0,1,1,0,1,1,1,1,1,0,5,0,0.000018
3331801624,3331801624,,0,1,1,0,1,1,2,0.666667,0.75,0,13,0,0.017924
1377379207525904384,1377379207525904384,,0,1,1,0,1,1,7,0.283203,0.300698,0,9,0,0.004809
1233719066,1233719066,,0,1,1,0,2,2,3,0.5,0.583333,0,206,0,0.000018
3372133061,3372133061,,0,1,1,0,1,1,2,0.666667,0.75,0,13,0,0.017924
820722220649615360,820722220649615360,,0,1,1,0,1,1,2,0.666667,0.75,0,13,0,0.017924
781860157735182336,781860157735182336,,0,1,1,0,1,1,2,0.666667,0.75,0,13,0,0.017924
1025032478451490816,1025032478451490816,,0,3,3,0,3,3,1,1,1,0,28,0,0.000588
967368417043992576,967368417043992576,,0,0,0,0,0,0,0,0,0,0,282,0,0
76615199,76615199,,0,0,0,0,0,0,0,0,0,0,283,0,0
2561943826,2561943826,,0,1,1,0,1,1,7,0.283203,0.300698,0,9,0,0.004809
230310402,230310402,,0,1,1,0,1,1,7,0.283203,0.300698,0,9,0,0.004809
634527162,634527162,,0,2,2,0,2,2,2,0.75,0.833333,0,15,0,0.018314
1933515392,1933515392,,0,0,0,0,0,0,0,0,0,0,284,0,0
1020251871888445440,1020251871888445440,,0,1,1,0,1,1,2,0.666667,0.75,0,5,0,0.020692
368202147,368202147,,0,0,0,0,0,0,0,0,0,0,285,0,0
416439103,416439103,,0,4,4,0,4,4,7,0.287791,0.311568,0,37,0,0.005283
1128224182750384128,1128224182750384128,,2,0,2,2,0,2,0,0,0,0,37,0.000154,0
1334620941750595584,1334620941750595584,,0,1,1,0,1,1,7,0.283203,0.300698,0,9,0,0.004809
1417369635536711680,1417369635536711680,,0,0,0,0,0,0,0,0,0,0,286,0,0
1085278669667483648,1085278669667483648,,0,1,1,0,1,1,7,0.283203,0.300698,0,9,0,0.004809
391070178,391070178,,0,1,1,0,1,1,2,0.666667,0.75,0,13,0,0.017924
2977852803,2977852803,,0,1,1,0,1,1,2,0.666667,0.75,0,5,0,0.020692
1381495649657614336,1381495649657614336,,0,1,1,0,1,1,2,0.666667,0.75,0,5,0,0.020692
178343808,178343808,,0,2,2,0,2,2,7,0.284035,0.303284,0,37,0,0.008253
2444670310,2444670310,,0,1,1,0,1,1,7,0.283203,0.300698,0,9,0,0.004809
1428780325803544576,1428780325803544576,,0,1,1,0,2,2,2,0.666667,0.75,0,13,0,0.017924
1433786199597101056,1433786199597101056,,0,2,2,0,2,2,6,0.391363,0.431264,0,9,0,0.008958
227456195,227456195,,0,0,0,0,0,0,0,0,0,0,287,0,0
2729521432,2729521432,,0,1,1,0,1,1,2,0.666667,0.75,0,13,0,0.017924
1416856550140952576,1416856550140952576,,0,1,1,0,1,1,7,0.283203,0.300698,0,9,0,0.004809
249599465,249599465,,0,1,1,0,1,1,7,0.283203,0.300698,0,9,0,0.004809
1341797019803901952,1341797019803901952,,0,1,1,0,1,1,2,0.666667,0.75,0,13,0,0.017924
353251479,353251479,,0,3,3,0,3,3,6,0.395634,0.436149,0,57,0,0.009204
1391077456325525504,1391077456325525504,,0,1,1,0,1,1,7,0.283203,0.300698,0,9,0,0.004809
1917139915,1917139915,,0,1,1,0,1,1,7,0.283203,0.300698,0,9,0,0.004809
1350218496903434240,1350218496903434240,,0,2,2,0,2,2,7,0.283757,0.302997,0,9,0,0.022733
1296512351487827968,1296512351487827968,,0,1,1,0,1,1,7,0.283203,0.300698,0,9,0,0.004809
339309372,339309372,,0,2,2,0,2,2,2,0.75,0.833333,0,37,0,0.021369
1239101399058788352,1239101399058788352,,0,2,2,0,2,2,7,0.283757,0.302997,0,9,0,0.022733
2768356420,2768356420,,0,1,1,0,1,1,2,0.666667,0.75,0,13,0,0.017924
1370689110986391552,1370689110986391552,,0,1,1,0,1,1,2,0.666667,0.75,0,5,0,0.020692
1843636171,1843636171,,0,0,0,0,0,0,0,0,0,0,288,0,0
1255987234832080896,1255987234832080896,,0,1,1,0,1,1,7,0.283203,0.300698,0,9,0,0.004809
185794895,185794895,,0,3,3,0,3,3,6,0.392422,0.433563,0,9,0,0.026883
2175541491,2175541491,,0,2,2,0,3,3,7,0.283757,0.302997,0,13,0,0.022733
1426557505975504896,1426557505975504896,,0,2,2,0,2,2,7,0.283757,0.302997,0,9,0,0.022733
442083142,442083142,,0,1,1,0,1,1,7,0.283203,0.300698,0,9,0,0.004809
289828856,289828856,,0,3,3,0,3,3,7,0.284736,0.305678,0,13,0,0.008838
236055365,236055365,,0,1,1,0,1,1,1,1,1,0,28,0,0.000001
1335017123194818560,1335017123194818560,,0,1,1,0,1,1,2,0.666667,0.75,0,5,0,0.020692
1423968905664647168,1423968905664647168,,0,2,2,0,2,2,6,0.391363,0.431264,0,9,0,0.008958
190978468,190978468,,0,1,1,0,1,1,7,0.283203,0.300698,0,9,0,0.004809
76382611,76382611,,0,1,1,0,1,1,7,0.283203,0.300698,0,9,0,0.004809
969572988554305536,969572988554305536,,0,1,1,0,1,1,2,0.666667,0.75,0,5,0,0.020692
235709376,235709376,,1,2,3,2,4,6,1,1,1,0.000031,9,0.000646,0
1343969535016259584,1343969535016259584,,1,0,1,2,0,2,0,0,0,0,9,0.000646,0
1436018788089180160,1436018788089180160,,0,1,1,0,1,1,2,0.666667,0.75,0,13,0,0.017924
1432091359620517888,1432091359620517888,,0,1,1,0,1,1,2,0.666667,0.75,0,13,0,0.017924
304266093,304266093,,0,1,1,0,3,3,2,0.666667,0.75,0,13,0,0.017924
2871241720,2871241720,,0,1,1,0,1,1,2,0.666667,0.75,0,5,0,0.020692
1222894268479524864,1222894268479524864,,0,1,1,0,1,1,1,1,1,0,28,0,0.000001
2494373125,2494373125,,0,1,1,0,1,1,2,0.666667,0.75,0,5,0,0.020692
2414586920,2414586920,,0,1,1,0,2,2,1,1,1,0,289,0,0
383692382,383692382,,1,0,1,2,0,2,0,0,0,0,289,0,0
1050364597558026240,1050364597558026240,,0,1,1,0,2,2,2,0.666667,0.75,0,13,0,0.017924
1432307502197231616,1432307502197231616,,0,0,0,0,0,0,0,0,0,0,290,0,0
1550368225,1550368225,,0,1,1,0,1,1,2,0.666667,0.75,0,13,0,0.017924
2672963418,2672963418,,0,1,1,0,1,1,2,0.666667,0.75,0,13,0,0.017924
25682941,25682941,,0,0,0,0,0,0,0,0,0,0,291,0,0
2209881884,2209881884,,0,1,1,0,1,1,2,0.666667,0.75,0,5,0,0.020692
1137660500,1137660500,,0,1,1,0,1,1,1,1,1,0,292,0,0
761802114335145984,761802114335145984,,1,0,1,1,0,1,0,0,0,0,292,0,0
1116742229144604672,1116742229144604672,,0,0,0,0,0,0,0,0,0,0,293,0,0
2182945495,2182945495,,1,0,1,2,0,2,0,0,0,0,13,0,0
310825756,310825756,,0,0,0,0,0,0,0,0,0,0,294,0,0
585934053,585934053,,0,0,0,0,0,0,0,0,0,0,295,0,0
1241295735360049152,1241295735360049152,,0,2,2,0,2,2,2,0.75,0.833333,0,15,0,0.019393
3232567245,3232567245,,0,1,1,0,2,2,1,1,1,0,13,0,0.000053
789963982476050432,789963982476050432,,0,1,1,0,1,1,1,1,1,0,14,0,0
1343955493212065792,1343955493212065792,,1,0,1,2,0,2,0,0,0,0,14,0,0
792007066021949440,792007066021949440,,0,1,1,0,1,1,2,0.666667,0.75,0,13,0,0.017924
1149193886,1149193886,,0,0,0,0,0,0,0,0,0,0,296,0,0
1419026834835005440,1419026834835005440,,0,1,1,0,1,1,1,1,1,0,13,0,0.000584
3024959435,3024959435,,0,1,1,0,1,1,2,0.666667,0.75,0,13,0,0.017924
937966642184810496,937966642184810496,,0,2,2,0,2,2,1,1,1,0,28,0,0.000001
827344747,827344747,,2,0,2,2,0,2,0,0,0,0,28,0,0
1428454807904395264,1428454807904395264,,0,1,1,0,1,1,1,1,1,0,13,0,0.000584
312888560,312888560,,0,1,1,0,1,1,2,0.666667,0.75,0,13,0,0.017924
2220513761,2220513761,,0,1,1,0,1,1,2,0.666667,0.75,0,13,0,0.017924
1067059978719162368,1067059978719162368,,0,2,2,0,2,2,6,0.391484,0.431813,0,9,0,0.022074
1364889477915811840,1364889477915811840,,0,1,1,0,1,1,2,0.666667,0.75,0,13,0,0.017924
260940801,260940801,,0,1,1,0,2,2,2,0.666667,0.75,0,13,0,0.017924
1409753412493787136,1409753412493787136,,0,2,2,0,2,2,2,0.75,0.833333,0,14,0,0.019438
472743659,472743659,,0,1,1,0,1,1,1,1,1,0,5,0,0.000237
375087721,375087721,,0,1,1,0,1,1,2,0.666667,0.75,0,13,0,0.017924
981797615078723584,981797615078723584,,0,1,1,0,1,1,2,0.666667,0.75,0,13,0,0.017924
1373731833863675904,1373731833863675904,,0,1,1,0,1,1,2,0.666667,0.75,0,13,0,0.017924
1192022675033640960,1192022675033640960,,0,1,1,0,1,1,2,0.666667,0.75,0,13,0,0.017924
2215696648,2215696648,,0,1,1,0,1,1,1,1,1,0,9,0,0.000943
899249568143081472,899249568143081472,,0,2,2,0,2,2,3,0.473684,0.555556,0,5,0,0.000545
1253073050049875968,1253073050049875968,,0,1,1,0,1,1,2,0.666667,0.75,0,13,0,0.017924
1207978284115472384,1207978284115472384,,0,1,1,0,1,1,2,0.666667,0.75,0,13,0,0.017924
514815592,514815592,,0,1,1,0,3,3,2,0.666667,0.75,0,13,0,0.017924
1111915132102344704,1111915132102344704,,0,1,1,0,1,1,2,0.666667,0.75,0,13,0,0.017924
1002601364747407360,1002601364747407360,,0,1,1,0,1,1,2,0.666667,0.75,0,13,0,0.017924
872371680,872371680,,0,1,1,0,1,1,1,1,1,0,13,0,0.000584
1000317689498341376,1000317689498341376,,0,1,1,0,2,2,2,0.666667,0.75,0,13,0,0.017924
2383636526,2383636526,,0,1,1,0,1,1,2,0.666667,0.75,0,13,0,0.017924
1447276410721144832,1447276410721144832,,0,1,1,0,1,1,1,1,1,0,9,0,0.000943
317042240,317042240,,0,1,1,0,1,1,2,0.666667,0.75,0,13,0,0.017924
786048613503819776,786048613503819776,,0,1,1,0,1,1,1,1,1,0,297,0,0
1349059048952487936,1349059048952487936,,1,0,1,1,0,1,0,0,0,0,297,0,0
1140346440260231168,1140346440260231168,,0,1,1,0,1,1,2,0.666667,0.75,0,13,0,0.017924
194245704,194245704,,0,1,1,0,1,1,2,0.666667,0.75,0,13,0,0.017924
1368850908,1368850908,,1,0,1,2,0,2,0,0,0,0,15,0.000627,0
1234553315985416192,1234553315985416192,,1,0,1,1,0,1,0,0,0,0,15,0.000627,0
184015853,184015853,,1,0,1,1,0,1,0,0,0,0,15,0.000627,0
2942061736,2942061736,,1,0,1,1,0,1,0,0,0,0,15,0.000627,0
853346632078962688,853346632078962688,,1,0,1,1,0,1,0,0,0,0,15,0.000627,0
391485689,391485689,,1,0,1,1,0,1,0,0,0,0,15,0.000627,0
821840939815698432,821840939815698432,,0,1,1,0,1,1,2,0.666667,0.75,0,13,0,0.017924
3590817526,3590817526,,0,1,1,0,1,1,2,0.666667,0.75,0,13,0,0.017924
1196367581789200384,1196367581789200384,,0,1,1,0,1,1,2,0.666667,0.75,0,13,0,0.017924
1092919224706785280,1092919224706785280,,0,1,1,0,1,1,2,0.666667,0.75,0,13,0,0.017924
1002742410,1002742410,,0,1,1,0,1,1,4,0.384615,0.483333,0,18,0,0
1334712547,1334712547,,1,1,2,1,1,2,3,0.5,0.583333,0,18,0,0.000016
1442889011966758912,1442889011966758912,,0,1,1,0,1,1,2,0.666667,0.75,0,13,0,0.017924
1272132059520208896,1272132059520208896,,0,1,1,0,1,1,2,0.666667,0.75,0,13,0,0.017924
459137740,459137740,,0,1,1,0,2,2,2,0.666667,0.75,0,13,0,0.017924
1347253323389407232,1347253323389407232,,0,1,1,0,1,1,2,0.666667,0.75,0,13,0,0.017924
943503939441487872,943503939441487872,,0,2,2,0,2,2,6,0.391484,0.431813,0,9,0,0.022074
815400228,815400228,,0,1,1,0,1,1,2,0.666667,0.75,0,13,0,0.017924
751098270047502336,751098270047502336,,0,1,1,0,1,1,2,0.666667,0.75,0,13,0,0.017924
1445719728216059904,1445719728216059904,,0,1,1,0,1,1,1,1,1,0,9,0,0.000943
1044843853243666432,1044843853243666432,,1,1,2,2,1,3,1,1,1,0.000005,19,0.000554,0
1220072246,1220072246,,2,0,2,2,0,2,0,0,0,0,14,0.000555,0
1253965695668412416,1253965695668412416,,2,1,3,2,1,3,1,1,1,0.000002,28,0.000556,0.000001
2241896284,2241896284,,1,0,1,1,0,1,0,0,0,0,19,0.000554,0
118374031,118374031,,0,1,1,0,2,2,2,0.666667,0.75,0,13,0,0.017924
3353160327,3353160327,,0,2,2,0,2,2,1,1,1,0,9,0,0.004387
1379378427099287552,1379378427099287552,,0,1,1,0,1,1,1,1,1,0,9,0,0.000943
1429815601174810624,1429815601174810624,,0,1,1,0,1,1,1,1,1,0,9,0,0.000943
5718002,5718002,,0,1,1,0,1,1,1,1,1,0,9,0,0.000943
1277339076362932224,1277339076362932224,,0,3,3,0,3,3,6,0.402161,0.441343,0,15,0,0.023664
79214086,79214086,,0,2,2,0,2,2,1,1,1,0,9,0,0.004387
1252305244014460928,1252305244014460928,,0,1,1,0,1,1,1,1,1,0,5,0,0.000237
1438923790004760576,1438923790004760576,,0,1,1,0,1,1,1,1,1,0,13,0,0.000584
1352643231826251776,1352643231826251776,,0,2,2,0,2,2,5,0.450575,0.473129,0,28,0,0.000046
1388476325372043264,1388476325372043264,,0,2,2,0,3,3,6,0.391484,0.431813,0,13,0,0.022074
862051194,862051194,,0,1,1,0,1,1,2,0.666667,0.75,0,13,0,0.017924
598098137,598098137,,0,1,1,0,1,1,2,0.666667,0.75,0,13,0,0.017924
910304714,910304714,,0,1,1,0,1,1,2,0.666667,0.75,0,13,0,0.017924
796267199153455104,796267199153455104,,0,1,1,0,1,1,2,0.666667,0.75,0,13,0,0.017924
979716832193019904,979716832193019904,,0,1,1,0,1,1,2,0.666667,0.75,0,13,0,0.017924
1266810164,1266810164,,0,1,1,0,1,1,2,0.666667,0.75,0,28,0,0.000006
77614099,77614099,,0,1,1,0,1,1,2,0.666667,0.75,0,13,0,0.017924
715609706,715609706,,0,1,1,0,1,1,1,1,1,0,28,0,0
9437162,9437162,,0,1,1,0,2,2,2,0.666667,0.75,0,13,0,0.017924
1313142152914972672,1313142152914972672,,0,1,1,0,2,2,2,0.666667,0.75,0,13,0,0.017924
1537330274,1537330274,,0,1,1,0,1,1,1,1,1,0,13,0,0.000584
2362758849,2362758849,,0,0,0,0,0,0,0,0,0,0,298,0,0
1359959343345655808,1359959343345655808,,0,1,1,0,1,1,2,0.666667,0.75,0,13,0,0.017924
1207947481813794816,1207947481813794816,,0,2,2,0,2,2,2,0.666667,0.75,0,21,0,0.018873
500025481,500025481,,0,1,1,0,1,1,2,0.666667,0.75,0,13,0,0.017924
1420033335619895296,1420033335619895296,,0,1,1,0,1,1,2,0.666667,0.75,0,13,0,0.017924
131262995,131262995,,0,1,1,0,2,2,2,0.666667,0.75,0,13,0,0.017924
1367496774,1367496774,,0,1,1,0,1,1,1,1,1,0,13,0,0.000584
761533447793958912,761533447793958912,,0,1,1,0,1,1,2,0.666667,0.75,0,13,0,0.017924
1275501158241533952,1275501158241533952,,1,0,1,1,0,1,0,0,0,0,14,0.000524,0
576520946,576520946,,0,2,2,0,2,2,2,0.75,0.833333,0,15,0,0.019393
1439650275736887296,1439650275736887296,,0,1,1,0,1,1,1,1,1,0,13,0,0.000003
1032260427479244800,1032260427479244800,,0,2,2,0,2,2,2,0.666667,0.75,0,21,0,0.018873
1239982145332031488,1239982145332031488,,0,1,1,0,1,1,2,0.666667,0.75,0,13,0,0.017924
1325195936193241088,1325195936193241088,,0,1,1,0,1,1,2,0.666667,0.75,0,13,0,0.017924
943778854778359808,943778854778359808,,0,1,1,0,1,1,2,0.666667,0.75,0,13,0,0.017924
2467935126,2467935126,,0,1,1,0,1,1,2,0.666667,0.75,0,13,0,0.017924
1398605094187376640,1398605094187376640,,0,1,1,0,1,1,2,0.666667,0.75,0,13,0,0.017924
412665412,412665412,,0,4,4,0,6,6,6,0.393646,0.436491,0,13,0,0.027032
884782095893188608,884782095893188608,,0,2,2,0,4,4,2,0.75,0.833333,0,13,0,0.019393
1250355750,1250355750,,0,3,3,0,3,3,4,0.492063,0.52957,0,13,0,0.005031
1447926252640296960,1447926252640296960,,0,0,0,0,0,0,0,0,0,0,299,0,0
498822979,498822979,,0,1,1,0,1,1,2,0.666667,0.75,0,13,0,0.017924
1354674610093088768,1354674610093088768,,0,1,1,0,1,1,2,0.666667,0.75,0,13,0,0.017924
1200905899742760960,1200905899742760960,,0,1,1,0,2,2,2,0.666667,0.75,0,13,0,0.017924
955314738,955314738,,0,1,1,0,1,1,2,0.666667,0.75,0,13,0,0.017924
1170775660907978752,1170775660907978752,,0,0,0,0,0,0,0,0,0,0,300,0,0
1028992122752573440,1028992122752573440,,0,1,1,0,1,1,2,0.666667,0.75,0,13,0,0.017924
1031901204828237824,1031901204828237824,,0,2,2,0,3,3,2,0.75,0.833333,0,13,0,0.019438
3964977808,3964977808,,1,0,1,2,0,2,0,0,0,0,9,0.000001,0
1221119130,1221119130,,0,1,1,0,1,1,2,0.666667,0.75,0,13,0,0.017924
1087495057735892992,1087495057735892992,,0,1,1,0,1,1,2,0.666667,0.75,0,13,0,0.017924
1281893371179667456,1281893371179667456,,1,0,1,1,0,1,0,0,0,0,13,0,0
198158656,198158656,,0,1,1,0,1,1,2,0.666667,0.75,0,13,0,0.017924
619258906,619258906,,0,0,0,0,0,0,0,0,0,0,301,0,0
1668671288,1668671288,,0,2,2,0,3,3,3,0.5,0.522222,0,13,0,0.018926
1440795305440514048,1440795305440514048,,0,0,0,0,0,0,0,0,0,0,302,0,0
927559177484034048,927559177484034048,,0,1,1,0,1,1,2,0.666667,0.75,0,13,0,0.017924
97948686,97948686,,0,1,1,0,1,1,2,0.666667,0.75,0,13,0,0.017924
948579747101052928,948579747101052928,,0,1,1,0,1,1,2,0.666667,0.75,0,13,0,0.017924
1102143643710824448,1102143643710824448,,0,1,1,0,1,1,2,0.666667,0.75,0,13,0,0.017924
1393825116,1393825116,,0,1,1,0,2,2,2,0.666667,0.75,0,13,0,0.017924
1160549639571070976,1160549639571070976,,0,1,1,0,1,1,2,0.666667,0.75,0,13,0,0.017924
1518699715,1518699715,,0,1,1,0,1,1,2,0.666667,0.75,0,13,0,0.017924
1366086962164154368,1366086962164154368,,1,0,1,1,0,1,0,0,0,0,21,0.000005,0
167473370,167473370,,0,1,1,0,1,1,2,0.666667,0.75,0,13,0,0.017924
800260353233854464,800260353233854464,,0,3,3,0,4,4,6,0.392562,0.434152,0,13,0,0.023588
1746294384,1746294384,,0,2,2,0,2,2,2,0.75,0.833333,0,13,0,0.018509
918929602864648192,918929602864648192,,0,1,1,0,1,1,2,0.666667,0.75,0,13,0,0.017924
2572492388,2572492388,,0,1,1,0,2,2,2,0.666667,0.75,0,13,0,0.017924
882338824155738112,882338824155738112,,0,1,1,0,1,1,2,0.666667,0.75,0,13,0,0.017924
1447909133815066624,1447909133815066624,,0,1,1,0,1,1,2,0.666667,0.75,0,13,0,0.017924
1369012889302994944,1369012889302994944,,0,1,1,0,1,1,2,0.666667,0.75,0,13,0,0.017924
1151477410648535040,1151477410648535040,,0,1,1,0,1,1,2,0.666667,0.75,0,13,0,0.017924
1227685320105365504,1227685320105365504,,0,1,1,0,1,1,2,0.666667,0.75,0,13,0,0.017924
1191090019,1191090019,,0,1,1,0,1,1,2,0.666667,0.75,0,13,0,0.017924
754403068725301248,754403068725301248,,0,1,1,0,1,1,1,1,1,0,13,0,0.000584
1427591372912185344,1427591372912185344,,0,1,1,0,1,1,2,0.666667,0.75,0,13,0,0.017924
789750300,789750300,,0,1,1,0,2,2,2,0.666667,0.75,0,13,0,0.017924
1195641066495582208,1195641066495582208,,0,1,1,0,1,1,2,0.666667,0.75,0,13,0,0.017924
489633908,489633908,,0,1,1,0,1,1,2,0.666667,0.75,0,13,0,0.017924
1241846534918098944,1241846534918098944,,0,3,3,0,4,4,3,0.545455,0.611111,0,13,0,0.018321
123574623,123574623,,0,1,1,0,1,1,2,0.666667,0.75,0,13,0,0.017924
1151785600326021120,1151785600326021120,,0,2,2,0,2,2,6,0.391484,0.431813,0,9,0,0.022074
187628447,187628447,,0,1,1,0,1,1,2,0.666667,0.75,0,13,0,0.017924
1255424295855144960,1255424295855144960,,1,1,2,1,2,3,1,1,1,0.000006,21,0.000552,0
251183660,251183660,,0,1,1,0,1,1,1,1,1,0,28,0,0.000001
112342798,112342798,,0,1,1,0,1,1,2,0.666667,0.75,0,13,0,0.017924
1449666405356408832,1449666405356408832,,0,1,1,0,1,1,1,1,1,0,5,0,0.000237
1418520440906059776,1418520440906059776,,0,1,1,0,1,1,2,0.666667,0.75,0,13,0,0.017924
326884492,326884492,,0,1,1,0,1,1,2,0.666667,0.75,0,13,0,0.017924
1431327327678615552,1431327327678615552,,0,2,2,0,2,2,6,0.391484,0.431813,0,9,0,0.022074
2510284195,2510284195,,0,1,1,0,1,1,2,0.666667,0.75,0,13,0,0.017924
1374632486681055232,1374632486681055232,,0,1,1,0,1,1,2,0.666667,0.75,0,13,0,0.017924
1415372460069990400,1415372460069990400,,0,2,2,0,2,2,6,0.391484,0.431813,0,9,0,0.022074
1422800010891173888,1422800010891173888,,0,0,0,0,0,0,0,0,0,0,303,0,0
1250837687214510080,1250837687214510080,,0,2,2,0,3,3,4,0.414286,0.462644,0,13,0,0.018294
1430246310142267392,1430246310142267392,,0,1,1,0,1,1,2,0.666667,0.75,0,13,0,0.017924
982505100,982505100,,0,2,2,0,2,2,6,0.391484,0.431813,0,9,0,0.022074
1029629678502531072,1029629678502531072,,0,1,1,0,2,2,1,1,1,0,304,0,0
3055135173,3055135173,,1,0,1,1,0,1,0,0,0,0,15,0.00023,0
486901061,486901061,,0,1,1,0,2,2,2,0.666667,0.75,0,13,0,0.017924
1333778355716562944,1333778355716562944,,0,1,1,0,2,2,2,0.666667,0.75,0,13,0,0.017924
1432682708539424768,1432682708539424768,,0,1,1,0,1,1,2,0.666667,0.75,0,13,0,0.017924
1056466845295935488,1056466845295935488,,0,1,1,0,1,1,2,0.666667,0.75,0,13,0,0.017924
710893536,710893536,,0,1,1,0,1,1,1,1,1,0,13,0,0.000584
1351957757809860608,1351957757809860608,,0,1,1,0,1,1,2,0.666667,0.75,0,13,0,0.017924
2660808424,2660808424,,0,1,1,0,1,1,2,0.666667,0.75,0,13,0,0.017924
1419043162681716736,1419043162681716736,,0,1,1,0,1,1,2,0.666667,0.75,0,13,0,0.017924
392552289,392552289,,1,1,2,1,1,2,1,1,1,0,13,0.000528,0.001513
294848675,294848675,,2,2,4,2,2,4,4,0.421053,0.53125,0.000038,14,0.000531,0.003477
1417435709422686208,1417435709422686208,,1,0,1,1,0,1,0,0,0,0,13,0.000528,0
572496475,572496475,,2,1,3,2,1,3,1,1,1,0.000001,13,0.001158,0.003445
77562743,77562743,,1,2,3,1,2,3,2,0.75,0.833333,0,13,0.000528,0.021369
1334572601029619712,1334572601029619712,,1,0,1,1,0,1,0,0,0,0,13,0.000528,0
787061199137566720,787061199137566720,,0,1,1,0,2,2,2,0.666667,0.75,0,13,0,0.017924
473929491,473929491,,0,1,1,0,1,1,1,1,1,0,13,0,0.000584
171463921,171463921,,0,1,1,0,1,1,2,0.666667,0.75,0,13,0,0.017924
3321096279,3321096279,,0,1,1,0,1,1,2,0.666667,0.75,0,13,0,0.017924
362441023,362441023,,0,1,1,0,1,1,2,0.666667,0.75,0,13,0,0.017924
767689615713206272,767689615713206272,,0,1,1,0,1,1,2,0.666667,0.75,0,13,0,0.017924
847346087161585664,847346087161585664,,0,1,1,0,1,1,2,0.666667,0.75,0,13,0,0.017924
508968552,508968552,,0,1,1,0,1,1,2,0.6,0.666667,0,206,0,0.000004
890940823,890940823,,0,1,1,0,1,1,1,1,1,0,305,0,0
287637599,287637599,,1,0,1,1,0,1,0,0,0,0,305,0,0
4195123455,4195123455,,0,1,1,0,2,2,2,0.666667,0.75,0,13,0,0.017924
743392270892695552,743392270892695552,,0,1,1,0,1,1,2,0.666667,0.75,0,13,0,0.017924
201936942,201936942,,0,1,1,0,1,1,2,0.666667,0.75,0,13,0,0.017924
1260555080,1260555080,,0,1,1,0,1,1,2,0.666667,0.75,0,13,0,0.017924
501491773,501491773,,0,1,1,0,1,1,2,0.666667,0.75,0,13,0,0.017924
1282323001720156160,1282323001720156160,,0,1,1,0,1,1,2,0.666667,0.75,0,13,0,0.017924
1113860002601631744,1113860002601631744,,0,1,1,0,1,1,2,0.666667,0.75,0,13,0,0.017924
1089276610728157184,1089276610728157184,,0,2,2,0,2,2,2,0.75,0.833333,0,13,0,0.018509
1356540109,1356540109,,0,1,1,0,1,1,2,0.666667,0.75,0,13,0,0.017924
1335203406,1335203406,,0,2,2,0,2,2,5,0.450575,0.473129,0,28,0,0.000046
1047675419858817024,1047675419858817024,,0,1,1,0,1,1,2,0.666667,0.75,0,13,0,0.017924
1326289942759223296,1326289942759223296,,0,1,1,0,1,1,2,0.666667,0.75,0,13,0,0.017924
524581709,524581709,,0,1,1,0,1,1,2,0.666667,0.75,0,13,0,0.017924
103055420,103055420,,0,1,1,0,1,1,2,0.666667,0.75,0,13,0,0.017924
1226921022781370368,1226921022781370368,,0,1,1,0,1,1,2,0.666667,0.75,0,13,0,0.017924
748913051768852480,748913051768852480,,0,1,1,0,1,1,2,0.666667,0.75,0,13,0,0.017924
990858403634466816,990858403634466816,,0,1,1,0,1,1,2,0.666667,0.75,0,13,0,0.017924
1440021872977104896,1440021872977104896,,0,1,1,0,1,1,2,0.666667,0.75,0,13,0,0.017924
1929877436,1929877436,,0,2,2,0,2,2,6,0.391484,0.431813,0,9,0,0.022074
910481652,910481652,,0,1,1,0,2,2,2,0.666667,0.75,0,13,0,0.017924
1201582677083742208,1201582677083742208,,0,1,1,0,1,1,2,0.666667,0.75,0,13,0,0.017924
1433678442046926848,1433678442046926848,,0,1,1,0,1,1,2,0.666667,0.75,0,13,0,0.017924
874606845511565312,874606845511565312,,0,1,1,0,1,1,2,0.666667,0.75,0,13,0,0.017924
1240674264069660672,1240674264069660672,,0,1,1,0,1,1,2,0.666667,0.75,0,13,0,0.017924
1419288341279920128,1419288341279920128,,0,1,1,0,1,1,2,0.666667,0.75,0,13,0,0.017924
86751656,86751656,,0,1,1,0,1,1,2,0.666667,0.75,0,13,0,0.017924
1235520348336123904,1235520348336123904,,0,1,1,0,1,1,2,0.666667,0.75,0,13,0,0.017924
877535285277597696,877535285277597696,,0,3,3,0,5,5,1,1,1,0,21,0,0.00064
908637973436084224,908637973436084224,,2,0,2,3,0,3,0,0,0,0,21,0.000019,0
1436091919726170112,1436091919726170112,,0,1,1,0,1,1,2,0.666667,0.75,0,13,0,0.017924
1258014750161731584,1258014750161731584,,0,1,1,0,1,1,2,0.666667,0.75,0,13,0,0.017924
2846795136,2846795136,,0,1,1,0,1,1,1,1,1,0,28,0,0
702214024,702214024,,0,1,1,0,1,1,2,0.666667,0.75,0,13,0,0.017924
1079002628711952384,1079002628711952384,,0,1,1,0,1,1,2,0.666667,0.75,0,13,0,0.017924
908316354972934144,908316354972934144,,0,1,1,0,1,1,2,0.666667,0.75,0,13,0,0.017924
879441189380001792,879441189380001792,,1,0,1,2,0,2,0,0,0,0,110,0.000801,0
604444515,604444515,,0,1,1,0,1,1,2,0.666667,0.75,0,13,0,0.017924
175166079,175166079,,0,1,1,0,1,1,2,0.666667,0.75,0,13,0,0.017924
1211950652898758656,1211950652898758656,,0,1,1,0,1,1,2,0.666667,0.75,0,13,0,0.017924
871379981632405504,871379981632405504,,0,1,1,0,1,1,2,0.666667,0.75,0,13,0,0.017924
476053480,476053480,,0,2,2,0,2,2,2,0.666667,0.75,0,15,0,0.017998
1336634188661985280,1336634188661985280,,0,1,1,0,1,1,2,0.666667,0.75,0,13,0,0.017924
1054285017181052928,1054285017181052928,,0,1,1,0,1,1,2,0.666667,0.75,0,13,0,0.017924
1449268408781004800,1449268408781004800,,0,0,0,0,0,0,0,0,0,0,306,0,0
606823551,606823551,,0,2,2,0,3,3,2,0.75,0.833333,0,250,0,0.01794
1450634974466543616,1450634974466543616,,2,0,2,4,0,4,0,0,0,0,250,0.000524,0
1419231151064068096,1419231151064068096,,0,1,1,0,1,1,2,0.666667,0.75,0,13,0,0.017924
3101569065,3101569065,,0,1,1,0,1,1,2,0.666667,0.75,0,13,0,0.017924
735878055982419968,735878055982419968,,0,1,1,0,1,1,2,0.666667,0.75,0,13,0,0.017924
1005171838618566656,1005171838618566656,,0,1,1,0,1,1,2,0.666667,0.75,0,13,0,0.017924
937112172,937112172,,0,1,1,0,2,2,2,0.666667,0.75,0,13,0,0.017924
70650884,70650884,,0,1,1,0,1,1,2,0.666667,0.75,0,13,0,0.017924
1259556813462278144,1259556813462278144,,0,1,1,0,1,1,2,0.666667,0.75,0,13,0,0.017924
1323060438,1323060438,,0,1,1,0,2,2,2,0.666667,0.75,0,13,0,0.017924
1363772105905627136,1363772105905627136,,0,1,1,0,1,1,2,0.666667,0.75,0,13,0,0.017924
441184561,441184561,,0,1,1,0,1,1,2,0.666667,0.75,0,13,0,0.017924
96204741,96204741,,1,0,1,1,0,1,0,0,0,0,9,0.000631,0
3944712676,3944712676,,1,1,2,1,1,2,1,1,1,0.000016,13,0.000631,0.000101
1126210020448903168,1126210020448903168,,1,1,2,1,1,2,1,1,1,0.000008,15,0.000631,0.000295
952864729625604096,952864729625604096,,1,0,1,1,0,1,0,0,0,0,9,0.000631,0
1443286886,1443286886,,1,0,1,1,0,1,0,0,0,0,9,0.000631,0
1430242480822394880,1430242480822394880,,1,0,1,1,0,1,0,0,0,0,9,0.000631,0
951467974858366976,951467974858366976,,1,0,1,1,0,1,0,0,0,0,9,0.000631,0
1397887511830138880,1397887511830138880,,1,0,1,1,0,1,0,0,0,0,9,0.000631,0
941928635715477504,941928635715477504,,1,0,1,1,0,1,0,0,0,0,9,0.000631,0
3225971279,3225971279,,1,0,1,1,0,1,0,0,0,0,9,0.000631,0
443926629,443926629,,1,0,1,1,0,1,0,0,0,0,9,0.000631,0
1434879707414151168,1434879707414151168,,1,0,1,1,0,1,0,0,0,0,9,0.000631,0
94337282,94337282,,1,0,1,1,0,1,0,0,0,0,9,0.000631,0
2320321929,2320321929,,1,0,1,1,0,1,0,0,0,0,9,0.000631,0
483995380,483995380,,1,1,2,1,1,2,1,1,1,0.000001,37,0.000631,0.003445
138707430,138707430,,1,0,1,1,0,1,0,0,0,0,9,0.000631,0
2389687188,2389687188,,1,0,1,1,0,1,0,0,0,0,9,0.000631,0
1167382299937296384,1167382299937296384,,1,0,1,1,0,1,0,0,0,0,9,0.000631,0
1370450129556279296,1370450129556279296,,1,0,1,1,0,1,0,0,0,0,9,0.000631,0
878679891385954304,878679891385954304,,1,0,1,1,0,1,0,0,0,0,9,0.000631,0
770035747,770035747,,1,0,1,1,0,1,0,0,0,0,9,0.000631,0
1008981710489489408,1008981710489489408,,1,0,1,1,0,1,0,0,0,0,9,0.000631,0
773460842276855808,773460842276855808,,1,0,1,1,0,1,0,0,0,0,9,0.000631,0
544836362,544836362,,1,0,1,1,0,1,0,0,0,0,9,0.000631,0
785936387623247872,785936387623247872,,1,0,1,1,0,1,0,0,0,0,9,0.000631,0
755522686684696576,755522686684696576,,1,1,2,1,1,2,1,1,1,0.000001,15,0.000631,0.001469
479498601,479498601,,1,0,1,1,0,1,0,0,0,0,9,0.000631,0
979492210889588736,979492210889588736,,1,0,1,1,0,1,0,0,0,0,9,0.000631,0
448784921,448784921,,1,0,1,1,0,1,0,0,0,0,9,0.000631,0
1141372158259712000,1141372158259712000,,1,0,1,1,0,1,0,0,0,0,9,0.000631,0
1417054752324657152,1417054752324657152,,1,0,1,1,0,1,0,0,0,0,9,0.000631,0
1272597183309676544,1272597183309676544,,1,0,1,1,0,1,0,0,0,0,9,0.000631,0
1022908251934011392,1022908251934011392,,1,2,3,1,2,3,3,0.538462,0.619048,0.000073,21,0.000631,0.000951
1101534236086026240,1101534236086026240,,1,0,1,1,0,1,0,0,0,0,9,0.000631,0
230787831,230787831,,1,0,1,1,0,1,0,0,0,0,9,0.000631,0
1168042548113358848,1168042548113358848,,1,0,1,1,0,1,0,0,0,0,9,0.000631,0
161996352,161996352,,1,0,1,1,0,1,0,0,0,0,9,0.000631,0
1033488919,1033488919,,1,1,2,1,1,2,1,1,1,0.000001,14,0.000631,0.001513
1466803693,1466803693,,1,0,1,1,0,1,0,0,0,0,9,0.000631,0
1376989130924691456,1376989130924691456,,1,0,1,1,0,1,0,0,0,0,9,0.000631,0
66147789,66147789,,1,0,1,1,0,1,0,0,0,0,9,0.000631,0
1364593031912030208,1364593031912030208,,1,0,1,1,0,1,0,0,0,0,9,0.000631,0
1351625952493768704,1351625952493768704,,1,0,1,1,0,1,0,0,0,0,9,0.000631,0
1205389459157585920,1205389459157585920,,1,0,1,1,0,1,0,0,0,0,9,0.000631,0
418245874,418245874,,1,0,1,1,0,1,0,0,0,0,9,0.000631,0
346844551,346844551,,1,0,1,1,0,1,0,0,0,0,9,0.000631,0
1307817119892082688,1307817119892082688,,2,0,2,2,0,2,0,0,0,0,15,0.000634,0
514670704,514670704,,1,0,1,1,0,1,0,0,0,0,9,0.000631,0
114694540,114694540,,1,0,1,1,0,1,0,0,0,0,9,0.000631,0
839559591746801664,839559591746801664,,1,0,1,1,0,1,0,0,0,0,9,0.000631,0
1910929976,1910929976,,1,1,2,1,1,2,2,0.666667,0.75,0,9,0.000631,0.017924
1242282432,1242282432,,1,0,1,1,0,1,0,0,0,0,9,0.000631,0
1188816626818396160,1188816626818396160,,1,0,1,1,0,1,0,0,0,0,9,0.000631,0
1362144619,1362144619,,1,0,1,1,0,1,0,0,0,0,9,0.000631,0
1421007460047929344,1421007460047929344,,1,0,1,1,0,1,0,0,0,0,9,0.000631,0
1016109625,1016109625,,1,0,1,1,0,1,0,0,0,0,9,0.000631,0
765867031988150272,765867031988150272,,1,0,1,1,0,1,0,0,0,0,9,0.000631,0
865205076159344640,865205076159344640,,1,0,1,1,0,1,0,0,0,0,9,0.000631,0
146429429,146429429,,1,0,1,1,0,1,0,0,0,0,9,0.000631,0
893088899043557376,893088899043557376,,1,0,1,1,0,1,0,0,0,0,9,0.000631,0
1170008913758052352,1170008913758052352,,1,0,1,1,0,1,0,0,0,0,9,0.000631,0
540369500,540369500,,1,1,2,1,1,2,2,0.666667,0.75,0,9,0.000631,0.017924
1187364870842392576,1187364870842392576,,1,1,2,1,2,3,1,1,1,0.000018,9,0.000631,0
716353562020855808,716353562020855808,,1,3,4,1,3,4,1,1,1,0.000015,15,0.000631,0.002148
1133374725764337664,1133374725764337664,,1,0,1,1,0,1,0,0,0,0,9,0.000631,0
1243672727959076864,1243672727959076864,,1,1,2,1,1,2,1,1,1,0.000002,25,0.000631,0.00062
1884471750,1884471750,,1,0,1,1,0,1,0,0,0,0,9,0.000631,0
426741815,426741815,,1,0,1,1,0,1,0,0,0,0,9,0.000631,0
1044494585001639936,1044494585001639936,,1,0,1,1,0,1,0,0,0,0,9,0.000631,0
1085678118289969152,1085678118289969152,,1,0,1,1,0,1,0,0,0,0,9,0.000631,0
475732955,475732955,,1,0,1,1,0,1,0,0,0,0,9,0.000631,0
1357221863181721600,1357221863181721600,,1,0,1,1,0,1,0,0,0,0,9,0.000631,0
542028193,542028193,,1,0,1,1,0,1,0,0,0,0,9,0.000631,0
366109520,366109520,,1,1,2,1,1,2,1,1,1,0.000001,15,0.000631,0.001469
547553319,547553319,,1,0,1,1,0,1,0,0,0,0,9,0.000631,0
1418099899372032000,1418099899372032000,,1,0,1,1,0,1,0,0,0,0,9,0.000631,0
1435534955858350080,1435534955858350080,,1,0,1,1,0,1,0,0,0,0,9,0.000631,0
1403000753199874048,1403000753199874048,,1,1,2,1,1,2,1,1,1,0.000018,9,0.000631,0
1033645348579930112,1033645348579930112,,1,0,1,1,0,1,0,0,0,0,9,0.000631,0
1374087042410418176,1374087042410418176,,1,0,1,1,0,1,0,0,0,0,9,0.000631,0
424506070,424506070,,1,0,1,1,0,1,0,0,0,0,9,0.000631,0
2329764297,2329764297,,1,0,1,1,0,1,0,0,0,0,9,0.000631,0
1341466118792355840,1341466118792355840,,1,0,1,1,0,1,0,0,0,0,9,0.000631,0
48182327,48182327,,1,1,2,1,1,2,1,1,1,0.000018,9,0.000631,0
1292671297,1292671297,,1,0,1,1,0,1,0,0,0,0,9,0.000631,0
1295094585098678272,1295094585098678272,,1,0,1,1,0,1,0,0,0,0,9,0.000631,0
1173244890001678336,1173244890001678336,,1,0,1,1,0,1,0,0,0,0,9,0.000631,0
1199811195013943296,1199811195013943296,,1,0,1,1,0,1,0,0,0,0,9,0.000631,0
1070688754342473728,1070688754342473728,,1,0,1,1,0,1,0,0,0,0,9,0.000631,0
883300814365896704,883300814365896704,,1,2,3,1,2,3,1,1,1,0.000003,25,0.000631,0.002134
994246141855322112,994246141855322112,,1,0,1,1,0,1,0,0,0,0,9,0.000631,0
2862730168,2862730168,,1,1,2,1,1,2,1,1,1,0.000008,15,0.000631,0.000295
73418713,73418713,,1,0,1,1,0,1,0,0,0,0,9,0.000631,0
848201472353464320,848201472353464320,,1,0,1,1,0,1,0,0,0,0,9,0.000631,0
1128620545019457536,1128620545019457536,,1,0,1,1,0,1,0,0,0,0,9,0.000631,0
4851430133,4851430133,,1,1,2,1,1,2,1,1,1,0.000017,18,0.000631,0.000055
988772702,988772702,,1,0,1,1,0,1,0,0,0,0,9,0.000631,0
971138218849656832,971138218849656832,,1,0,1,1,0,1,0,0,0,0,9,0.000631,0
1419579818564276224,1419579818564276224,,1,0,1,1,0,1,0,0,0,0,9,0.000631,0
1040358985,1040358985,,1,0,1,1,0,1,0,0,0,0,9,0.000631,0
900310491414790144,900310491414790144,,1,0,1,1,0,1,0,0,0,0,9,0.000631,0
137643354,137643354,,1,0,1,1,0,1,0,0,0,0,9,0.000631,0
1171336100,1171336100,,1,1,2,1,1,2,1,1,1,0.000001,15,0.000631,0.001469
965292818288791552,965292818288791552,,1,0,1,1,0,1,0,0,0,0,9,0.000631,0
859866889689976832,859866889689976832,,1,0,1,1,0,1,0,0,0,0,9,0.000631,0
1242118112,1242118112,,1,0,1,1,0,1,0,0,0,0,9,0.000631,0
1373132725,1373132725,,1,1,2,1,1,2,4,0.46875,0.491667,0.000176,14,0.000631,0.001002
1237372389438169088,1237372389438169088,,1,0,1,1,0,1,0,0,0,0,9,0.000631,0
4385611643,4385611643,,1,1,2,1,1,2,1,1,1,0.000002,25,0.000631,0.00062
2181983214,2181983214,,1,0,1,1,0,1,0,0,0,0,9,0.000631,0
452777469,452777469,,2,0,2,2,0,2,0,0,0,0,9,0.000631,0
1008709562,1008709562,,2,3,5,4,3,7,2,0.714286,0.8,0.000056,15,0.000634,0.001825
519379680,519379680,,1,1,2,1,2,3,2,0.666667,0.75,0,13,0.000631,0.017924
298491635,298491635,,1,0,1,1,0,1,0,0,0,0,9,0.000631,0
178272080,178272080,,1,0,1,1,0,1,0,0,0,0,9,0.000631,0
860751768753516544,860751768753516544,,1,0,1,1,0,1,0,0,0,0,9,0.000631,0
3037724913,3037724913,,1,0,1,1,0,1,0,0,0,0,9,0.000631,0
2738188342,2738188342,,1,0,1,1,0,1,0,0,0,0,9,0.000631,0
50267238,50267238,,1,0,1,1,0,1,0,0,0,0,9,0.000631,0
494428507,494428507,,1,3,4,1,3,4,2,0.8,0.875,0.000038,25,0.000631,0.004068
1447197001142124544,1447197001142124544,,1,0,1,1,0,1,0,0,0,0,9,0.000631,0
1344802960749060096,1344802960749060096,,1,0,1,1,0,1,0,0,0,0,9,0.000631,0
1430984925273104384,1430984925273104384,,1,0,1,1,0,1,0,0,0,0,9,0.000631,0
1026634270247403520,1026634270247403520,,1,0,1,1,0,1,0,0,0,0,9,0.000631,0
1337144779772194816,1337144779772194816,,1,2,3,1,3,4,2,0.666667,0.75,0.000019,21,0.000631,0.018036
1434073225902841856,1434073225902841856,,1,0,1,1,0,1,0,0,0,0,9,0.000631,0
99907118,99907118,,1,0,1,1,0,1,0,0,0,0,9,0.000631,0
1130775457,1130775457,,1,0,1,1,0,1,0,0,0,0,9,0.000631,0
965897887,965897887,,1,0,1,1,0,1,0,0,0,0,9,0.000631,0
1440704012584579072,1440704012584579072,,1,0,1,1,0,1,0,0,0,0,9,0.000631,0
422187496,422187496,,1,0,1,1,0,1,0,0,0,0,9,0.000631,0
1293807233713790976,1293807233713790976,,1,0,1,1,0,1,0,0,0,0,9,0.000631,0
4822115279,4822115279,,1,1,2,1,1,2,1,1,1,0.000009,9,0.000631,0.000308
128525796,128525796,,1,0,1,1,0,1,0,0,0,0,9,0.000631,0
3172430939,3172430939,,2,2,4,2,2,4,1,1,1,0.000013,15,0.000634,0.001577
1418841815554351104,1418841815554351104,,1,0,1,1,0,1,0,0,0,0,9,0.000631,0
203891785,203891785,,1,1,2,1,1,2,3,0.444444,0.5,0.000052,18,0.000631,0.000308
1109789138,1109789138,,1,0,1,1,0,1,0,0,0,0,9,0.000631,0
864546176,864546176,,1,0,1,1,0,1,0,0,0,0,9,0.000631,0
1364430734,1364430734,,1,0,1,1,0,1,0,0,0,0,9,0.000631,0
1930820899,1930820899,,1,1,2,1,1,2,2,0.666667,0.75,0.000004,21,0.000631,0.000949
966702165095059456,966702165095059456,,2,0,2,3,0,3,0,0,0,0,15,0.000634,0
79167737,79167737,,1,0,1,1,0,1,0,0,0,0,9,0.000631,0
932375939987763200,932375939987763200,,1,0,1,1,0,1,0,0,0,0,9,0.000631,0
141509471,141509471,,2,3,5,2,3,5,2,0.636364,0.714286,0.000055,21,0.001162,0.004412
1145988000733696000,1145988000733696000,,1,2,3,1,2,3,1,1,1,0.000003,21,0.000631,0.00431
72123290,72123290,,1,0,1,1,0,1,0,0,0,0,9,0.000631,0
1236749663333687296,1236749663333687296,,1,0,1,1,0,1,0,0,0,0,9,0.000631,0
1104837016833921024,1104837016833921024,,1,0,1,1,0,1,0,0,0,0,9,0.000631,0
2199827589,2199827589,,1,0,1,1,0,1,0,0,0,0,9,0.000631,0
529718462,529718462,,1,0,1,1,0,1,0,0,0,0,9,0.000631,0
1251850799602376704,1251850799602376704,,1,0,1,1,0,1,0,0,0,0,9,0.000631,0
1221128126341750784,1221128126341750784,,1,1,2,1,1,2,1,1,1,0.000013,14,0.000631,0
1234599734158991360,1234599734158991360,,1,1,2,1,2,3,1,1,1,0.000018,9,0.000631,0
541002879,541002879,,1,0,1,1,0,1,0,0,0,0,9,0.000631,0
1184454718875164672,1184454718875164672,,1,0,1,1,0,1,0,0,0,0,9,0.000631,0
4549605137,4549605137,,1,0,1,1,0,1,0,0,0,0,9,0.000631,0
49685654,49685654,,1,0,1,1,0,1,0,0,0,0,9,0.000631,0
3418726954,3418726954,,1,0,1,1,0,1,0,0,0,0,9,0.000631,0
1402917292300804096,1402917292300804096,,1,0,1,1,0,1,0,0,0,0,9,0.000631,0
20552360,20552360,,1,2,3,1,2,3,2,0.75,0.833333,0.000001,14,0.000631,0.019438
1062643914,1062643914,,1,0,1,1,0,1,0,0,0,0,9,0.000631,0
536769582,536769582,,1,0,1,1,0,1,0,0,0,0,9,0.000631,0
3024781929,3024781929,,1,0,1,1,0,1,0,0,0,0,9,0.000631,0
1365350315122446336,1365350315122446336,,1,0,1,1,0,1,0,0,0,0,9,0.000631,0
2203429105,2203429105,,1,2,3,1,2,3,2,0.75,0.833333,0.000001,37,0.000631,0.021369
1405487488098054144,1405487488098054144,,1,2,3,1,2,3,1,1,1,0.000003,21,0.000631,0.002335
365557136,365557136,,1,0,1,1,0,1,0,0,0,0,9,0.000631,0
1420992954781605888,1420992954781605888,,1,0,1,1,0,1,0,0,0,0,9,0.000631,0
98833228,98833228,,1,0,1,1,0,1,0,0,0,0,9,0.000631,0
77231645,77231645,,1,0,1,1,0,1,0,0,0,0,9,0.000631,0
1356896318,1356896318,,1,0,1,1,0,1,0,0,0,0,9,0.000631,0
1404500147707518976,1404500147707518976,,1,0,1,1,0,1,0,0,0,0,9,0.000631,0
3262283944,3262283944,,1,2,3,1,2,3,2,0.6,0.666667,0.000039,57,0.000631,0.01817
3034249541,3034249541,,1,0,1,1,0,1,0,0,0,0,9,0.000631,0
1384612046189248512,1384612046189248512,,1,0,1,1,0,1,0,0,0,0,9,0.000631,0
726721856749842432,726721856749842432,,1,1,2,1,1,2,1,1,1,0.000001,14,0.000631,0.001513
1015928949287870464,1015928949287870464,,1,0,1,1,0,1,0,0,0,0,9,0.000631,0
1050753675445104640,1050753675445104640,,0,1,1,0,2,2,2,0.666667,0.75,0,13,0,0.017924
782111222745427968,782111222745427968,,0,1,1,0,1,1,2,0.666667,0.75,0,13,0,0.017924
1071073146143457280,1071073146143457280,,0,1,1,0,1,1,2,0.666667,0.75,0,13,0,0.017924
1432336239664025600,1432336239664025600,,0,1,1,0,1,1,1,1,1,0,13,0,0.000584
1405805238196580352,1405805238196580352,,0,1,1,0,1,1,2,0.666667,0.75,0,13,0,0.017924
3131341079,3131341079,,0,1,1,0,1,1,2,0.666667,0.75,0,13,0,0.017924
2437501161,2437501161,,0,1,1,0,1,1,1,1,1,0,13,0,0.000584
539030033,539030033,,0,1,1,0,1,1,2,0.666667,0.75,0,13,0,0.017924
2348497224,2348497224,,1,0,1,2,0,2,0,0,0,0,13,0,0
104485125,104485125,,1,0,1,2,0,2,0,0,0,0,13,0,0
3356803871,3356803871,,0,1,1,0,1,1,2,0.666667,0.75,0,13,0,0.017924
1236347126,1236347126,,0,1,1,0,1,1,2,0.666667,0.75,0,13,0,0.017924
1199143163765637120,1199143163765637120,,0,1,1,0,1,1,2,0.666667,0.75,0,13,0,0.017924
1380074825700499456,1380074825700499456,,0,1,1,0,1,1,2,0.666667,0.75,0,13,0,0.017924
4171519895,4171519895,,0,1,1,0,1,1,2,0.666667,0.75,0,13,0,0.017924
1206167282600357888,1206167282600357888,,0,1,1,0,1,1,1,1,1,0,5,0,0.000237
760828881779720192,760828881779720192,,0,1,1,0,1,1,2,0.666667,0.75,0,13,0,0.017924
1152192533063241728,1152192533063241728,,0,1,1,0,1,1,2,0.666667,0.75,0,13,0,0.017924
507106168,507106168,,0,1,1,0,1,1,2,0.666667,0.75,0,13,0,0.017924
1323189736660443136,1323189736660443136,,0,1,1,0,1,1,2,0.666667,0.75,0,13,0,0.017924
724554112864497664,724554112864497664,,0,1,1,0,1,1,2,0.666667,0.75,0,13,0,0.017924
2782537521,2782537521,,0,1,1,0,2,2,2,0.666667,0.75,0,13,0,0.017924
4141162227,4141162227,,0,1,1,0,1,1,2,0.666667,0.75,0,13,0,0.017924
433418060,433418060,,0,1,1,0,1,1,1,1,1,0,28,0,0.000001
1051158772738154496,1051158772738154496,,0,3,3,0,3,3,2,0.8,0.875,0,21,0,0.022235
1030050011151826944,1030050011151826944,,0,1,1,0,1,1,2,0.666667,0.75,0,13,0,0.017924
4192961459,4192961459,,0,1,1,0,1,1,1,1,1,0,307,0,0
922544159327768576,922544159327768576,,1,0,1,1,0,1,0,0,0,0,307,0,0
2338484714,2338484714,,0,2,2,0,2,2,2,0.75,0.833333,0,13,0,0.018025
213045066,213045066,,0,1,1,0,1,1,2,0.666667,0.75,0,13,0,0.017924
1423975235427131392,1423975235427131392,,0,1,1,0,1,1,2,0.666667,0.75,0,13,0,0.017924
1376526700410994688,1376526700410994688,,0,0,0,0,0,0,0,0,0,0,308,0,0
1094718444837265408,1094718444837265408,,1,1,2,3,2,5,1,1,1,0.00001,25,0.000531,0
4098830355,4098830355,,1,0,1,1,0,1,0,0,0,0,25,0.000531,0
4189354889,4189354889,,1,0,1,1,0,1,0,0,0,0,25,0.000531,0
289296210,289296210,,1,0,1,1,0,1,0,0,0,0,25,0.000531,0
1255552749258911744,1255552749258911744,,1,0,1,1,0,1,0,0,0,0,25,0.000531,0
1248608241606463488,1248608241606463488,,1,2,3,1,2,3,1,1,1,0,25,0.000531,0.002335
813735255534399488,813735255534399488,,1,0,1,1,0,1,0,0,0,0,25,0.000531,0
504558286,504558286,,1,1,2,1,1,2,2,0.666667,0.75,0,25,0.000531,0.017924
1362056386713157632,1362056386713157632,,1,0,1,1,0,1,0,0,0,0,25,0.000531,0
1601926596,1601926596,,1,1,2,1,1,2,1,1,1,0,25,0.000531,0.00062
496075532,496075532,,2,0,2,3,0,3,0,0,0,0,15,0.000534,0
3393812847,3393812847,,1,0,1,1,0,1,0,0,0,0,25,0.000531,0
1349656058650886144,1349656058650886144,,0,1,1,0,1,1,2,0.666667,0.75,0,13,0,0.017924
16814076,16814076,,1,0,1,2,0,2,0,0,0,0,13,0.000533,0
2884530100,2884530100,,1,0,1,2,0,2,0,0,0,0,13,0.000533,0
114205805,114205805,,1,0,1,1,0,1,0,0,0,0,13,0.000533,0
1032967056,1032967056,,0,1,1,0,2,2,2,0.666667,0.75,0,13,0,0.017924
1106542788357902336,1106542788357902336,,0,1,1,0,1,1,2,0.666667,0.75,0,13,0,0.017924
2412421439,2412421439,,0,1,1,0,1,1,1,1,1,0,5,0,0.000237
963079626863054848,963079626863054848,,0,1,1,0,1,1,2,0.666667,0.75,0,13,0,0.017924
3345673576,3345673576,,0,1,1,0,1,1,2,0.666667,0.75,0,13,0,0.017924
1434413154319077376,1434413154319077376,,0,1,1,0,1,1,2,0.666667,0.75,0,13,0,0.017924
1238955925362421760,1238955925362421760,,0,1,1,0,1,1,2,0.666667,0.75,0,13,0,0.017924
3184776298,3184776298,,0,1,1,0,1,1,1,1,1,0,5,0,0.000237
1000061496,1000061496,,0,2,2,0,3,3,2,0.666667,0.75,0,9,0,0.017978
441311649,441311649,,0,1,1,0,1,1,2,0.666667,0.75,0,13,0,0.017924
549225146,549225146,,0,1,1,0,1,1,2,0.666667,0.75,0,13,0,0.017924
931581540026454016,931581540026454016,,0,1,1,0,1,1,2,0.666667,0.75,0,13,0,0.017924
1263429113802620928,1263429113802620928,,0,1,1,0,1,1,2,0.666667,0.75,0,13,0,0.017924
1449291533686030336,1449291533686030336,,0,1,1,0,1,1,1,1,1,0,5,0,0.000237
1260652389113171968,1260652389113171968,,2,0,2,2,0,2,0,0,0,0,13,0.000001,0
4635116367,4635116367,,0,2,2,0,3,3,2,0.75,0.833333,0,13,0,0.021369
1226206460,1226206460,,0,2,2,0,2,2,2,0.75,0.833333,0,15,0,0.017972
70725626,70725626,,0,2,2,0,4,4,2,0.75,0.833333,0,14,0,0.019438
429168630,429168630,,0,1,1,0,1,1,2,0.666667,0.75,0,13,0,0.017924
2361073892,2361073892,,0,1,1,0,1,1,2,0.666667,0.75,0,13,0,0.017924
481529114,481529114,,0,1,1,0,1,1,2,0.666667,0.75,0,13,0,0.017924
716630421598040064,716630421598040064,,0,1,1,0,1,1,2,0.666667,0.75,0,13,0,0.017924
592489826,592489826,,0,1,1,0,1,1,1,1,1,0,28,0,0
253540043,253540043,,0,1,1,0,1,1,2,0.666667,0.75,0,13,0,0.017924
1426357669,1426357669,,0,1,1,0,1,1,2,0.666667,0.75,0,13,0,0.017924
246352595,246352595,,0,2,2,0,2,2,2,0.75,0.833333,0,37,0,0.021369
1244199163648147456,1244199163648147456,,0,1,1,0,1,1,2,0.666667,0.75,0,13,0,0.017924
122014351,122014351,,0,0,0,0,0,0,0,0,0,0,309,0,0
1449995064051122176,1449995064051122176,,1,0,1,2,0,2,0,0,0,0,14,0,0
1254860570702098432,1254860570702098432,,2,1,3,3,2,5,1,1,1,0.00001,14,0,0
505865910,505865910,,1,1,2,2,2,4,1,1,1,0.00001,14,0,0
1279090723762180096,1279090723762180096,,2,0,2,3,0,3,0,0,0,0,14,0,0
623728435,623728435,,2,1,3,3,1,4,2,0.571429,0.625,0.000028,14,0,0.000036
1037261274,1037261274,,1,0,1,1,0,1,0,0,0,0,14,0,0
1425131051454713856,1425131051454713856,,2,0,2,2,0,2,0,0,0,0,28,0,0
2280648054,2280648054,,1,0,1,2,0,2,0,0,0,0,14,0,0
1084450777748459520,1084450777748459520,,1,0,1,2,0,2,0,0,0,0,14,0,0
1367973715,1367973715,,1,0,1,2,0,2,0,0,0,0,14,0,0
1041484481406873600,1041484481406873600,,1,0,1,1,0,1,0,0,0,0,14,0,0
124132478,124132478,,1,0,1,1,0,1,0,0,0,0,14,0,0
2612174829,2612174829,,1,0,1,1,0,1,0,0,0,0,14,0,0
1411014281777364992,1411014281777364992,,2,1,3,2,1,3,1,1,1,0.000007,18,0,0.000092
1306653928474529792,1306653928474529792,,1,0,1,1,0,1,0,0,0,0,14,0,0
1060581943404883968,1060581943404883968,,1,0,1,1,0,1,0,0,0,0,14,0,0
807187174743478272,807187174743478272,,1,1,2,1,1,2,1,1,1,0,14,0,0.001513
2935611094,2935611094,,0,1,1,0,3,3,1,1,1,0,14,0,0.001513
2847028163,2847028163,,1,0,1,1,0,1,0,0,0,0,15,0,0
1237807159754264576,1237807159754264576,,0,1,1,0,1,1,1,1,1,0,310,0,0
1086700214,1086700214,,1,0,1,1,0,1,0,0,0,0,310,0,0
2370915699,2370915699,,0,1,1,0,1,1,1,1,1,0,37,0,0
699288457626181632,699288457626181632,,0,1,1,0,2,2,2,0.545455,0.583333,0,28,0,0
1448754755111723008,1448754755111723008,,0,0,0,0,0,0,0,0,0,0,311,0,0
1429727081584332800,1429727081584332800,,0,2,2,0,4,4,3,0.5,0.583333,0,110,0,0.000048
1284792823330594816,1284792823330594816,,0,1,1,0,1,1,1,1,1,0,312,0,0
2695769460,2695769460,,5,0,5,5,0,5,0,0,0,0,312,0,0
1732467540,1732467540,,0,1,1,0,1,1,1,1,1,0,13,0,0.00007
808245668074717184,808245668074717184,,0,1,1,0,1,1,1,1,1,0,28,0,0.000003
434411545,434411545,,0,0,0,0,0,0,0,0,0,0,313,0,0
1394283849220231168,1394283849220231168,,1,0,1,1,0,1,0,0,0,0,18,0,0
56826659,56826659,,0,1,1,0,1,1,1,1,1,0,314,0,0
22601899,22601899,,1,0,1,1,0,1,0,0,0,0,314,0,0
451531867,451531867,,0,0,0,0,0,0,0,0,0,0,315,0,0
78901034,78901034,,0,0,0,0,0,0,0,0,0,0,316,0,0
1310523096751800320,1310523096751800320,,1,0,1,1,0,1,0,0,0,0,15,0.000003,0
366660837,366660837,,1,2,3,1,2,3,1,1,1,0.000001,21,0.000003,0.001814
1254390256557871104,1254390256557871104,,1,0,1,1,0,1,0,0,0,0,15,0.000003,0
3415953789,3415953789,,1,0,1,1,0,1,0,0,0,0,15,0.000003,0
992467121090322432,992467121090322432,,1,2,3,2,2,4,1,1,1,0.000001,15,0.000003,0.002134
1150751883566493696,1150751883566493696,,1,2,3,1,2,3,1,1,1,0.000001,21,0.000003,0.002379
1412496949111050240,1412496949111050240,,1,0,1,1,0,1,0,0,0,0,15,0.000003,0
1528202852,1528202852,,1,0,1,1,0,1,0,0,0,0,15,0.000003,0
1011902735845863424,1011902735845863424,,1,0,1,1,0,1,0,0,0,0,15,0.000003,0
2940530079,2940530079,,1,0,1,1,0,1,0,0,0,0,15,0.000003,0
457953920,457953920,,1,0,1,1,0,1,0,0,0,0,15,0.000003,0
2172696231,2172696231,,1,0,1,1,0,1,0,0,0,0,15,0.000003,0
98435091,98435091,,1,0,1,1,0,1,0,0,0,0,15,0.000003,0
845257288143290368,845257288143290368,,1,0,1,1,0,1,0,0,0,0,15,0.000003,0
1244348233402462208,1244348233402462208,,1,0,1,1,0,1,0,0,0,0,15,0.000003,0
4142340874,4142340874,,1,0,1,1,0,1,0,0,0,0,15,0.000003,0
1351993606849114112,1351993606849114112,,1,0,1,1,0,1,0,0,0,0,15,0.000003,0
617997188,617997188,,1,0,1,1,0,1,0,0,0,0,15,0.000003,0
850324301450555392,850324301450555392,,1,0,1,1,0,1,0,0,0,0,15,0.000003,0
1429184056017698816,1429184056017698816,,1,0,1,1,0,1,0,0,0,0,15,0.000003,0
604576676,604576676,,1,0,1,2,0,2,0,0,0,0,15,0.000003,0
2736138412,2736138412,,1,0,1,1,0,1,0,0,0,0,15,0.000003,0
800852166252593152,800852166252593152,,1,0,1,1,0,1,0,0,0,0,15,0.000003,0
2548428572,2548428572,,1,1,2,1,1,2,2,0.666667,0.75,0.000001,21,0.000003,0.000949
1138194846588526592,1138194846588526592,,1,0,1,1,0,1,0,0,0,0,15,0.000003,0
1424716983854112768,1424716983854112768,,2,1,3,2,1,3,2,0.666667,0.75,0.000001,9,0.000004,0.017924
1404096270705344512,1404096270705344512,,1,0,1,1,0,1,0,0,0,0,15,0.000003,0
2358336535,2358336535,,1,0,1,1,0,1,0,0,0,0,15,0.000003,0
1391005627342802944,1391005627342802944,,1,0,1,1,0,1,0,0,0,0,15,0.000003,0
582626236,582626236,,1,0,1,1,0,1,0,0,0,0,15,0.000003,0
474442199,474442199,,1,0,1,1,0,1,0,0,0,0,15,0.000003,0
636300132,636300132,,4,1,5,4,1,5,1,1,1,0.000001,15,0.000003,0.003445
936743900806565888,936743900806565888,,1,0,1,1,0,1,0,0,0,0,15,0.000003,0
1422573109413138432,1422573109413138432,,1,0,1,1,0,1,0,0,0,0,15,0.000003,0
4869130227,4869130227,,1,0,1,1,0,1,0,0,0,0,15,0.000003,0
372937945,372937945,,1,0,1,1,0,1,0,0,0,0,15,0.000003,0
2335685027,2335685027,,1,0,1,1,0,1,0,0,0,0,15,0.000003,0
1410287057004544000,1410287057004544000,,1,0,1,1,0,1,0,0,0,0,15,0.000003,0
1372026416,1372026416,,1,1,2,1,1,2,1,1,1,0,14,0.000003,0.001513
894659348,894659348,,1,0,1,1,0,1,0,0,0,0,15,0.000003,0
942395277209755648,942395277209755648,,1,0,1,1,0,1,0,0,0,0,15,0.000003,0
517932775,517932775,,1,1,2,1,1,2,1,1,1,0.000001,15,0.000003,0.00039
1104761490,1104761490,,0,0,0,0,0,0,0,0,0,0,317,0,0
92043546,92043546,,0,1,1,0,1,1,1,1,1,0,28,0,0.000003
712607537489715200,712607537489715200,,0,1,1,0,1,1,1,1,1,0,57,0,0
264774390,264774390,,4,0,4,4,0,4,0,0,0,0,57,0.000001,0
1117395933472395264,1117395933472395264,,0,1,1,0,1,1,1,1,1,0,28,0,0
2288626020,2288626020,,0,1,1,0,1,1,5,0.449942,0.471782,0,28,0,0.000046
1240578860225363968,1240578860225363968,,0,1,1,0,1,1,4,0.45,0.486111,0,9,0,0.00027
2558496329,2558496329,,0,1,1,0,1,1,5,0.449942,0.471782,0,28,0,0.000046
440333722,440333722,,0,0,0,0,0,0,0,0,0,0,318,0,0
430837818,430837818,,0,0,0,0,0,0,0,0,0,0,319,0,0
1229171145997455360,1229171145997455360,,1,0,1,1,0,1,0,0,0,0,9,0.000001,0
845083238,845083238,,1,0,1,1,0,1,0,0,0,0,9,0.000001,0
1408827164,1408827164,,1,0,1,1,0,1,0,0,0,0,9,0.000001,0
403302750,403302750,,1,0,1,1,0,1,0,0,0,0,9,0.000001,0
1189297099957035008,1189297099957035008,,1,0,1,1,0,1,0,0,0,0,9,0.000001,0
130399684,130399684,,1,0,1,1,0,1,0,0,0,0,9,0.000001,0
1386266787923349504,1386266787923349504,,1,0,1,1,0,1,0,0,0,0,9,0.000001,0
289803948,289803948,,1,0,1,1,0,1,0,0,0,0,9,0.000001,0
1471927075,1471927075,,1,0,1,1,0,1,0,0,0,0,9,0.000001,0
857323772906483712,857323772906483712,,1,0,1,1,0,1,0,0,0,0,9,0.000001,0
831860163372015616,831860163372015616,,0,1,1,0,1,1,1,1,1,0,13,0,0.00007
262504476,262504476,,0,1,1,0,1,1,1,1,1,0,37,0,0.003445
1238374100629893120,1238374100629893120,,0,0,0,0,0,0,0,0,0,0,320,0,0
370239400,370239400,,0,1,1,0,1,1,1,1,1,0,321,0,0
196190210,196190210,,2,0,2,2,0,2,0,0,0,0,321,0,0
585288950,585288950,,0,1,1,0,1,1,1,1,1,0,13,0,0.00007
404310336,404310336,,0,1,1,0,1,1,1,1,1,0,322,0,0
1441392447909679104,1441392447909679104,,1,0,1,1,0,1,0,0,0,0,322,0,0
1046478197402062848,1046478197402062848,,0,0,0,0,0,0,0,0,0,0,323,0,0
1583751032,1583751032,,1,0,1,2,0,2,0,0,0,0,28,0,0
2471595815,2471595815,,1,0,1,1,0,1,0,0,0,0,28,0,0
1367947156842233856,1367947156842233856,,1,0,1,1,0,1,0,0,0,0,28,0,0
427737238,427737238,,1,0,1,1,0,1,0,0,0,0,28,0,0
453094475,453094475,,1,0,1,1,0,1,0,0,0,0,28,0,0
502998687,502998687,,0,1,1,0,1,1,1,1,1,0,28,0,0.000003
1291439929,1291439929,,0,1,1,0,1,1,1,1,1,0,110,0,0
328935079,328935079,,5,0,5,6,0,6,0,0,0,0,110,0.000002,0
1074410824595398656,1074410824595398656,,0,8,8,0,12,12,2,0.9,0.944444,0,28,0,0
447231894,447231894,,2,0,2,4,0,4,0,0,0,0,206,0,0
1321498328371265536,1321498328371265536,,1,0,1,2,0,2,0,0,0,0,28,0,0
1117159062,1117159062,,1,0,1,2,0,2,0,0,0,0,28,0,0
500053935,500053935,,1,0,1,1,0,1,0,0,0,0,28,0,0
1381715311607607296,1381715311607607296,,0,2,2,0,2,2,5,0.450575,0.473129,0,28,0,0.000046
847506571,847506571,,0,0,0,0,0,0,0,0,0,0,324,0,0
2523336293,2523336293,,0,1,1,0,1,1,2,0.666667,0.75,0,13,0,0.017924
796079716772016128,796079716772016128,,0,1,1,0,1,1,5,0.449942,0.471782,0,28,0,0.000046
469483334,469483334,,0,1,1,0,1,1,1,1,1,0,312,0,0
1257622974,1257622974,,0,1,1,0,1,1,1,1,1,0,312,0,0
1257213938707595264,1257213938707595264,,0,1,1,0,2,2,2,0.571429,0.625,0,25,0,0.000036
1246211106948907008,1246211106948907008,,0,1,1,0,1,1,2,0.666667,0.75,0,21,0,0.000949
75248775,75248775,,0,1,1,0,1,1,1,1,1,0,28,0,0.000003
1345048825434697728,1345048825434697728,,0,0,0,0,0,0,0,0,0,0,325,0,0
469286534,469286534,,0,1,1,0,2,2,5,0.449942,0.471782,0,28,0,0.000046
3861951201,3861951201,,0,1,1,0,1,1,1,1,1,0,14,0,0.000019
1027608429840551936,1027608429840551936,,0,1,1,0,1,1,1,1,1,0,9,0,0.000308
1030894188290826240,1030894188290826240,,0,1,1,0,1,1,2,0.666667,0.75,0,15,0,0.000104
1625408460,1625408460,,0,1,1,0,1,1,1,1,1,0,28,0,0.000003
514161086,514161086,,0,1,1,0,1,1,1,1,1,0,19,0,0
2362414802,2362414802,,0,1,1,0,1,1,1,1,1,0,28,0,0.000003
1429020218706247680,1429020218706247680,,0,1,1,0,3,3,1,1,1,0,326,0,0
1058705067392581632,1058705067392581632,,1,0,1,3,0,3,0,0,0,0,326,0,0
1061598152,1061598152,,1,0,1,2,0,2,0,0,0,0,28,0,0
452064464,452064464,,1,0,1,2,0,2,0,0,0,0,28,0,0
1067854512,1067854512,,0,1,1,0,1,1,1,1,1,0,15,0,0.00039
1104179964407095296,1104179964407095296,,0,1,1,0,1,1,1,1,1,0,9,0,0.000308
1297515399265779712,1297515399265779712,,0,2,2,0,2,2,5,0.450575,0.473129,0,28,0,0.000048
4221550048,4221550048,,0,1,1,0,1,1,5,0.449942,0.471782,0,28,0,0.000046
821851199070699520,821851199070699520,,0,0,0,0,0,0,0,0,0,0,327,0,0
69874682,69874682,,0,0,0,0,0,0,0,0,0,0,328,0,0
341390520,341390520,,0,1,1,0,1,1,3,0.5,0.555556,0,21,0,0.000086
3032825368,3032825368,,0,2,2,0,2,2,3,0.457143,0.489583,0,28,0,0.000038
1392509544,1392509544,,0,1,1,0,1,1,2,0.666667,0.75,0,15,0,0.000104
284044783,284044783,,0,1,1,0,1,1,1,1,1,0,28,0,0.000003
237922323,237922323,,0,1,1,0,1,1,1,1,1,0,19,0,0
1081962270912143360,1081962270912143360,,0,1,1,0,1,1,5,0.449942,0.471782,0,28,0,0.000046
2495475256,2495475256,,0,1,1,0,1,1,1,1,1,0,28,0,0.000003
866705562049945600,866705562049945600,,0,2,2,0,2,2,5,0.450575,0.473129,0,28,0,0.000048
1393562082,1393562082,,0,2,2,0,2,2,5,0.450575,0.473129,0,28,0,0.000048
608879426,608879426,,0,1,1,0,1,1,5,0.449942,0.471782,0,28,0,0.000046
828561296698253312,828561296698253312,,0,1,1,0,1,1,1,1,1,0,28,0,0.000003
1201691502,1201691502,,0,1,1,0,1,1,1,1,1,0,28,0,0.000003
3154530838,3154530838,,0,1,1,0,1,1,1,1,1,0,28,0,0.000003
49167821,49167821,,0,1,1,0,1,1,1,1,1,0,28,0,0.000003
1325511110548738048,1325511110548738048,,0,1,1,0,1,1,2,0.666667,0.75,0,21,0,0.000011
393374768,393374768,,0,1,1,0,1,1,1,1,1,0,28,0,0.000003
407742061,407742061,,0,1,1,0,1,1,1,1,1,0,28,0,0.000003
170845973,170845973,,0,1,1,0,1,1,1,1,1,0,28,0,0.000003
1248347579383009280,1248347579383009280,,0,1,1,0,1,1,1,1,1,0,37,0,0.003445
60042349,60042349,,0,1,1,0,1,1,1,1,1,0,28,0,0.000003
1361833561972686848,1361833561972686848,,0,1,1,0,1,1,4,0.46875,0.491667,0,14,0,0.001002
909111343,909111343,,0,1,1,0,1,1,1,1,1,0,28,0,0.000003
269885887,269885887,,0,1,1,0,1,1,1,1,1,0,37,0,0.003445
1442889222772322304,1442889222772322304,,0,1,1,0,1,1,1,1,1,0,14,0,0.000045
1227587522567512064,1227587522567512064,,0,1,1,0,2,2,4,0.46875,0.491667,0,14,0,0.001002
104239528,104239528,,0,3,3,0,4,4,5,0.451613,0.47483,0,28,0,0.00005
473323380,473323380,,0,1,1,0,1,1,1,1,1,0,37,0,0.003445
707207821,707207821,,0,1,1,0,1,1,3,0.5,0.555556,0,21,0,0.000086
40217208,40217208,,0,0,0,0,0,0,0,0,0,0,329,0,0
851456388,851456388,,0,2,2,0,3,3,1,1,1,0,13,0,0.000033
1215413739182346240,1215413739182346240,,1,0,1,1,0,1,0,0,0,0,13,0.000001,0
2347398695,2347398695,,0,1,1,0,1,1,1,1,1,0,312,0,0
1349647983600689152,1349647983600689152,,0,1,1,0,1,1,1,1,1,0,28,0,0.000003
725949864,725949864,,2,0,2,4,0,4,0,0,0,0,21,0.000046,0
817997,817997,,0,1,1,0,1,1,1,1,1,0,15,0,0.00039
2688705527,2688705527,,0,1,1,0,1,1,1,1,1,0,312,0,0
1174792591713406976,1174792591713406976,,0,1,1,0,1,1,1,1,1,0,37,0,0.003445
486763718,486763718,,0,0,0,0,0,0,0,0,0,0,330,0,0
1325445649337364480,1325445649337364480,,0,1,1,0,1,1,1,1,1,0,37,0,0.003445
490741722,490741722,,0,1,1,0,1,1,1,1,1,0,14,0,0.000019
771197191,771197191,,0,1,1,0,1,1,1,1,1,0,37,0,0.003445
1447162886913204224,1447162886913204224,,0,0,0,0,0,0,0,0,0,0,331,0,0
2508021147,2508021147,,0,1,1,0,1,1,1,1,1,0,37,0,0.003445
454365633,454365633,,0,1,1,0,1,1,1,1,1,0,37,0,0.003445
1447105363,1447105363,,0,1,1,0,1,1,5,0.449942,0.471782,0,28,0,0.000046
198443221,198443221,,0,0,0,0,0,0,0,0,0,0,332,0,0
835516741,835516741,,0,1,1,0,1,1,1,1,1,0,15,0,0.001469
490409207,490409207,,0,0,0,0,0,0,0,0,0,0,333,0,0
88017073,88017073,,0,1,1,0,1,1,5,0.449942,0.471782,0,28,0,0.000046
82068999,82068999,,0,1,1,0,1,1,1,1,1,0,28,0,0.000003
1106188385591402496,1106188385591402496,,0,3,3,0,4,4,5,0.475091,0.487724,0,28,0,0.000081
2928270711,2928270711,,0,1,1,0,1,1,5,0.449942,0.471782,0,28,0,0.000046
1402761891886288896,1402761891886288896,,0,1,1,0,1,1,1,1,1,0,334,0,0
1413422334594232320,1413422334594232320,,1,0,1,1,0,1,0,0,0,0,334,0,0
55796259,55796259,,1,0,1,2,0,2,0,0,0,0,15,0,0
438790885,438790885,,0,0,0,0,0,0,0,0,0,0,335,0,0
447010531,447010531,,0,1,1,0,1,1,6,0.28169,0.320417,0,15,0,0.000083
187351126,187351126,,1,0,1,1,0,1,0,0,0,0,9,0,0
3376130901,3376130901,,0,0,0,0,0,0,0,0,0,0,336,0,0
1222886635,1222886635,,1,0,1,1,0,1,0,0,0,0,9,0,0
1920258536,1920258536,,0,1,1,0,1,1,1,1,1,0,9,0,0.000308
1038168487741595648,1038168487741595648,,0,0,0,0,0,0,0,0,0,0,337,0,0
1382309073819930624,1382309073819930624,,0,1,1,0,1,1,1,1,1,0,57,0,0
153634387,153634387,,0,0,0,0,0,0,0,0,0,0,338,0,0
257130763,257130763,,0,1,1,0,1,1,1,1,1,0,28,0,0.000003
721799988234346496,721799988234346496,,1,0,1,1,0,1,0,0,0,0,15,0,0
993404693484396544,993404693484396544,,1,0,1,1,0,1,0,0,0,0,15,0,0
769161057764081664,769161057764081664,,1,0,1,1,0,1,0,0,0,0,15,0,0
1217682216567873536,1217682216567873536,,1,0,1,1,0,1,0,0,0,0,15,0,0
2219871178,2219871178,,1,0,1,1,0,1,0,0,0,0,15,0,0
2872974977,2872974977,,1,0,1,1,0,1,0,0,0,0,15,0,0
1449405412734812160,1449405412734812160,,0,1,1,0,1,1,1,1,1,0,28,0,0.000003
75978805,75978805,,0,5,5,0,9,9,1,1,1,0,110,0,0.000028
24195377,24195377,,1,0,1,2,0,2,0,0,0,0,110,0.000001,0
38669647,38669647,,1,0,1,2,0,2,0,0,0,0,110,0.000001,0
928593562211676160,928593562211676160,,1,0,1,1,0,1,0,0,0,0,110,0.000001,0
2662719205,2662719205,,0,1,1,0,1,1,1,1,1,0,9,0,0.000308
2333859956,2333859956,,0,1,1,0,1,1,1,1,1,0,28,0,0.000003
292544185,292544185,,0,1,1,0,1,1,1,1,1,0,28,0,0.000003
710500851270492160,710500851270492160,,1,1,2,1,1,2,1,1,1,0.000018,25,0.000119,0
3860260755,3860260755,,0,0,0,0,0,0,0,0,0,0,339,0,0
3306587122,3306587122,,0,1,1,0,1,1,1,1,1,0,15,0,0.00039
1448161844200411136,1448161844200411136,,0,0,0,0,0,0,0,0,0,0,340,0,0
219226566,219226566,,0,2,2,0,2,2,1,1,1,0,110,0,0.000006
764215328528269312,764215328528269312,,1,0,1,1,0,1,0,0,0,0,110,0,0
443233660,443233660,,0,0,0,0,0,0,0,0,0,0,341,0,0
2216179636,2216179636,,0,1,1,0,1,1,1,1,1,0,28,0,0.000018
2275247204,2275247204,,0,0,0,0,0,0,0,0,0,0,342,0,0
33994488,33994488,,0,1,1,0,1,1,3,0.449275,0.473118,0,28,0,0.000035
876189487,876189487,,0,1,1,0,1,1,5,0.449942,0.471782,0,28,0,0.000046
1344370051659526144,1344370051659526144,,0,1,1,0,2,2,1,1,1,0,343,0,0
762905483380391936,762905483380391936,,2,0,2,4,0,4,0,0,0,0,343,0,0
233489435,233489435,,0,1,1,0,1,1,1,1,1,0,28,0,0.000018
1134238657,1134238657,,0,1,1,0,1,1,1,1,1,0,28,0,0.000003
1376226833000173568,1376226833000173568,,0,4,4,0,4,4,2,0.833333,0.9,0,14,0,0.019763
733307603665686528,733307603665686528,,0,1,1,0,1,1,1,1,1,0,28,0,0.000003
4218365097,4218365097,,0,1,1,0,1,1,2,0.666667,0.75,0,21,0,0.000011
1242191332652785664,1242191332652785664,,0,1,1,0,1,1,1,1,1,0,9,0,0.000308
983339761,983339761,,0,0,0,0,0,0,0,0,0,0,344,0,0
1431700337669328896,1431700337669328896,,0,1,1,0,2,2,1,1,1,0,14,0,0.001513
535800174,535800174,,0,1,1,0,1,1,4,0.421053,0.489583,0,15,0,0.000431
1222235658305052672,1222235658305052672,,0,1,1,0,2,2,3,0.5,0.519608,0,28,0,0
110475372,110475372,,0,1,1,0,1,1,1,1,1,0,28,0,0
1087656649228210176,1087656649228210176,,0,1,1,0,1,1,1,1,1,0,28,0,0.000003
3020531027,3020531027,,0,1,1,0,1,1,4,0.421053,0.489583,0,15,0,0.000431
242667025,242667025,,0,2,2,0,2,2,5,0.450575,0.473129,0,28,0,0.000048
2188803397,2188803397,,0,2,2,0,2,2,2,0.75,0.833333,0,57,0,0
332993378,332993378,,1,1,2,1,1,2,1,1,1,0,57,0,0
19553775,19553775,,0,1,1,0,1,1,1,1,1,0,28,0,0.000003
56392390,56392390,,0,1,1,0,1,1,1,1,1,0,57,0,0
1012718378,1012718378,,0,1,1,0,1,1,1,1,1,0,57,0,0
292364008,292364008,,0,1,1,0,1,1,1,1,1,0,28,0,0
476038082,476038082,,0,1,1,0,1,1,1,1,1,0,28,0,0.000003
566308252,566308252,,0,1,1,0,1,1,1,1,1,0,28,0,0.000018
988641757,988641757,,0,0,0,0,0,0,0,0,0,0,345,0,0
1109063856721145856,1109063856721145856,,0,0,0,0,0,0,0,0,0,0,346,0,0
128616804,128616804,,0,1,1,0,1,1,1,1,1,0,28,0,0.000003
1048258778,1048258778,,0,0,0,0,0,0,0,0,0,0,347,0,0
1181427840,1181427840,,0,1,1,0,1,1,1,1,1,0,28,0,0.000003
937044130378735616,937044130378735616,,0,1,1,0,1,1,1,1,1,0,28,0,0.000003
4288686554,4288686554,,0,0,0,0,0,0,0,0,0,0,348,0,0
1287422621404073984,1287422621404073984,,0,1,1,0,1,1,1,1,1,0,28,0,0.000003
2279301,2279301,,0,1,1,0,1,1,1,1,1,0,28,0,0.000003
1684975140,1684975140,,0,1,1,0,1,1,1,1,1,0,28,0,0.000003
241972508,241972508,,0,1,1,0,1,1,1,1,1,0,28,0,0.000003
2209347581,2209347581,,0,1,1,0,1,1,1,1,1,0,28,0,0.000003
78579998,78579998,,0,1,1,0,1,1,1,1,1,0,28,0,0.000003
157342922,157342922,,0,1,1,0,1,1,1,1,1,0,28,0,0.000003
1116836748,1116836748,,0,1,1,0,1,1,1,1,1,0,28,0,0.000003
740715938769711104,740715938769711104,,0,1,1,0,1,1,3,0.5,0.537037,0,15,0,0.000348
975761831905169408,975761831905169408,,0,1,1,0,1,1,2,0.518519,0.535714,0,57,0,0.000004
425260173,425260173,,0,1,1,0,1,1,1,1,1,0,28,0,0.000003
466028028,466028028,,1,0,1,1,0,1,0,0,0,0,28,0,0
2845668851,2845668851,,0,1,1,0,1,1,5,0.449942,0.471782,0,28,0,0.000046
1019449079858855936,1019449079858855936,,1,0,1,2,0,2,0,0,0,0,9,0,0
2391090577,2391090577,,0,2,2,0,2,2,2,0.535714,0.566667,0,57,0,0.000004
1448770841282498560,1448770841282498560,,0,1,1,0,1,1,1,1,1,0,194,0,0
1317283324704952320,1317283324704952320,,0,1,1,0,1,1,2,0.571429,0.625,0,57,0,0.000246
1350520074931740672,1350520074931740672,,0,1,1,0,1,1,2,0.666667,0.75,0,349,0,0
1373976746429665280,1373976746429665280,,1,1,2,1,1,2,1,1,1,0,349,0,0
420614018,420614018,,0,1,1,0,1,1,2,0.571429,0.625,0,21,0,0.000019
1361065909813731328,1361065909813731328,,1,0,1,1,0,1,0,0,0,0,349,0,0
1111694110119870464,1111694110119870464,,0,1,1,0,1,1,1,1,1,0,28,0,0.000003
492958448,492958448,,0,1,1,0,1,1,1,1,1,0,350,0,0
2714596672,2714596672,,1,0,1,1,0,1,0,0,0,0,350,0,0
1729205360,1729205360,,0,2,2,0,2,2,4,0.45,0.546296,0,15,0,0.001945
183170537,183170537,,0,1,1,0,1,1,1,1,1,0,28,0,0.000003
964719079,964719079,,0,2,2,0,2,2,4,0.454545,0.541667,0,15,0,0.00138
3398494691,3398494691,,0,0,0,0,0,0,0,0,0,0,351,0,0
325760306,325760306,,0,1,1,0,1,1,1,1,1,0,19,0,0
2299665715,2299665715,,0,1,1,0,1,1,1,1,1,0,28,0,0.000003
1427969957879586816,1427969957879586816,,0,1,1,0,1,1,1,1,1,0,28,0,0.000003
1658117701,1658117701,,0,1,1,0,1,1,5,0.449942,0.471782,0,28,0,0.000046
4548385835,4548385835,,0,1,1,0,1,1,1,1,1,0,28,0,0.000003
2440740653,2440740653,,1,0,1,1,0,1,0,0,0,0,28,0.000001,0
2870353479,2870353479,,3,0,3,5,0,5,0,0,0,0,28,0.000001,0
1047995852,1047995852,,0,0,0,0,0,0,0,0,0,0,352,0,0
1336271833075736576,1336271833075736576,,0,1,1,0,1,1,2,0.518519,0.535714,0,57,0,0.000004
532976626,532976626,,1,0,1,1,0,1,0,0,0,0,9,0,0
406576358,406576358,,0,1,1,0,1,1,1,1,1,0,28,0,0.000003
1025746433201373184,1025746433201373184,,0,1,1,0,1,1,1,1,1,0,28,0,0.000003
389679304,389679304,,1,1,2,2,2,4,1,1,1,0.000002,28,0,0
1313460308925612032,1313460308925612032,,1,0,1,2,0,2,0,0,0,0,28,0,0
1430204997405401088,1430204997405401088,,1,0,1,1,0,1,0,0,0,0,28,0,0
9862602,9862602,,1,0,1,1,0,1,0,0,0,0,28,0,0
1404121928571490304,1404121928571490304,,0,1,1,0,1,1,1,1,1,0,28,0,0.000003
2412647393,2412647393,,0,0,0,0,0,0,0,0,0,0,353,0,0
1334158115554603008,1334158115554603008,,0,1,1,0,1,1,1,1,1,0,28,0,0.000003
779733862293405696,779733862293405696,,0,1,1,0,1,1,5,0.449942,0.471782,0,28,0,0.000046
472905491,472905491,,0,1,1,0,1,1,1,1,1,0,19,0,0
248210377,248210377,,0,2,2,0,2,2,5,0.461629,0.479284,0,28,0,0.000046
963911001992323072,963911001992323072,,0,1,1,0,1,1,1,1,1,0,354,0,0
2922904461,2922904461,,1,0,1,1,0,1,0,0,0,0,354,0,0
186124512,186124512,,0,0,0,0,0,0,0,0,0,0,355,0,0
1381585691591782400,1381585691591782400,,1,0,1,2,0,2,0,0,0,0,28,0,0
1248592634752401408,1248592634752401408,,1,0,1,1,0,1,0,0,0,0,28,0,0
4481243657,4481243657,,1,0,1,1,0,1,0,0,0,0,28,0,0
141924802,141924802,,1,0,1,1,0,1,0,0,0,0,28,0,0
1162717109266329600,1162717109266329600,,1,1,2,1,1,2,1,1,1,0,57,0,0.000035
1365743538122731520,1365743538122731520,,1,0,1,1,0,1,0,0,0,0,28,0,0
1011465899600220160,1011465899600220160,,1,0,1,1,0,1,0,0,0,0,28,0,0
1284144582,1284144582,,1,0,1,1,0,1,0,0,0,0,28,0,0
1338141139585658880,1338141139585658880,,1,0,1,1,0,1,0,0,0,0,28,0,0
1345787251343699968,1345787251343699968,,1,0,1,1,0,1,0,0,0,0,28,0,0
2925117455,2925117455,,1,0,1,1,0,1,0,0,0,0,28,0,0
2336750753,2336750753,,1,0,1,1,0,1,0,0,0,0,28,0,0
340458077,340458077,,1,0,1,1,0,1,0,0,0,0,28,0,0
1166184584981045248,1166184584981045248,,1,0,1,1,0,1,0,0,0,0,28,0,0
909890162829795328,909890162829795328,,0,1,1,0,1,1,5,0.449942,0.471782,0,28,0,0.000046
1030336356,1030336356,,0,1,1,0,1,1,5,0.449942,0.471782,0,28,0,0.000046
410957161,410957161,,0,1,1,0,1,1,5,0.449942,0.471782,0,28,0,0.000046
2261631554,2261631554,,0,1,1,0,1,1,1,1,1,0,37,0,0.003445
951545291429249024,951545291429249024,,0,1,1,0,2,2,5,0.449942,0.471782,0,28,0,0.000046
483010642,483010642,,0,1,1,0,1,1,5,0.449942,0.471782,0,28,0,0.000046
230413185,230413185,,0,0,0,0,0,0,0,0,0,0,356,0,0
1365464605,1365464605,,0,0,0,0,0,0,0,0,0,0,357,0,0
2866061393,2866061393,,0,1,1,0,1,1,5,0.449942,0.471782,0,28,0,0.000046
1377977208929665024,1377977208929665024,,0,2,2,0,2,2,1,1,1,0,15,0,0.000022
1251098358137139200,1251098358137139200,,1,0,1,1,0,1,0,0,0,0,33,0,0
1632482760,1632482760,,0,1,1,0,2,2,5,0.449942,0.471782,0,28,0,0.000046
994297575921549312,994297575921549312,,0,0,0,0,0,0,0,0,0,0,358,0,0
928048873,928048873,,0,0,0,0,0,0,0,0,0,0,359,0,0
330245226,330245226,,0,1,1,0,1,1,5,0.449942,0.471782,0,28,0,0.000046
2352233100,2352233100,,0,0,0,0,0,0,0,0,0,0,360,0,0
2514624711,2514624711,,0,0,0,0,0,0,0,0,0,0,361,0,0
54686988,54686988,,0,0,0,0,0,0,0,0,0,0,362,0,0
354558383,354558383,,0,0,0,0,0,0,0,0,0,0,363,0,0
1432428252560334848,1432428252560334848,,0,0,0,0,0,0,0,0,0,0,364,0,0
1289158231437312000,1289158231437312000,,0,1,1,0,1,1,3,0.449275,0.473118,0,28,0,0.000035
67965753,67965753,,0,0,0,0,0,0,0,0,0,0,365,0,0
704662373483864064,704662373483864064,,1,0,1,1,0,1,0,0,0,0,21,0.000001,0
1139353296,1139353296,,0,0,0,0,0,0,0,0,0,0,366,0,0
1429841493158674432,1429841493158674432,,0,0,0,0,0,0,0,0,0,0,367,0,0
1357682898,1357682898,,0,0,0,0,0,0,0,0,0,0,368,0,0
398789550,398789550,,0,1,1,0,1,1,5,0.449942,0.471782,0,28,0,0.000046
880161000,880161000,,0,1,1,0,1,1,5,0.449942,0.471782,0,28,0,0.000046
2351753245,2351753245,,0,0,0,0,0,0,0,0,0,0,369,0,0
130516387,130516387,,0,1,1,0,1,1,2,0.571429,0.625,0,57,0,0.000246
1006400634,1006400634,,0,1,1,0,1,1,1,1,1,0,19,0,0
953542285,953542285,,0,1,1,0,1,1,1,1,1,0,19,0,0
542509465,542509465,,0,0,0,0,0,0,0,0,0,0,370,0,0
1231603440,1231603440,,1,0,1,1,0,1,0,0,0,0,18,0,0
1226124266,1226124266,,1,0,1,1,0,1,0,0,0,0,18,0,0
3290984981,3290984981,,0,2,2,0,2,2,2,0.535714,0.566667,0,19,0,0.000004
1144353966572154880,1144353966572154880,,0,0,0,0,0,0,0,0,0,0,371,0,0
1417986764967383040,1417986764967383040,,1,0,1,1,0,1,0,0,0,0,19,0,0
1216820800164110336,1216820800164110336,,1,0,1,1,0,1,0,0,0,0,19,0,0
1412690060957323264,1412690060957323264,,0,2,2,0,2,2,5,0.45098,0.473487,0,28,0,0.000047
227239711,227239711,,0,1,1,0,1,1,1,1,1,0,372,0,0
97465851,97465851,,1,0,1,1,0,1,0,0,0,0,372,0,0
549269257,549269257,,0,2,2,0,2,2,2,0.625,0.7,0,57,0,0.00028
2332571271,2332571271,,0,1,1,0,1,1,2,0.518519,0.535714,0,57,0,0.000004
1275517602,1275517602,,0,1,1,0,2,2,5,0.449942,0.471782,0,28,0,0.000046
884023737745645568,884023737745645568,,0,1,1,0,2,2,5,0.449942,0.471782,0,28,0,0.000046
211090942,211090942,,0,1,1,0,1,1,1,1,1,0,25,0,0.00062
17921374,17921374,,0,1,1,0,1,1,2,0.571429,0.625,0,57,0,0.000246
106842211,106842211,,0,0,0,0,0,0,0,0,0,0,373,0,0
1265636392475987968,1265636392475987968,,0,0,0,0,0,0,0,0,0,0,374,0,0
582152087,582152087,,0,1,1,0,1,1,1,1,1,0,19,0,0
960992657588785152,960992657588785152,,0,0,0,0,0,0,0,0,0,0,375,0,0
7250482,7250482,,0,0,0,0,0,0,0,0,0,0,376,0,0
1340391143465512960,1340391143465512960,,0,1,1,0,1,1,2,0.666667,0.75,0,28,0,0.00002
861666300,861666300,,0,1,1,0,1,1,1,1,1,0,37,0,0.003445
1022538426,1022538426,,0,1,1,0,1,1,3,0.449275,0.473118,0,28,0,0.000035
1115512071221854208,1115512071221854208,,0,0,0,0,0,0,0,0,0,0,377,0,0
261670870,261670870,,0,1,1,0,1,1,1,1,1,0,15,0,0.00039
1194993033160380416,1194993033160380416,,0,1,1,0,1,1,1,1,1,0,19,0,0
1436738194356199424,1436738194356199424,,0,1,1,0,1,1,1,1,1,0,378,0,0
4227017272,4227017272,,3,0,3,3,0,3,0,0,0,0,378,0,0
2338909003,2338909003,,0,1,1,0,1,1,5,0.449942,0.471782,0,28,0,0.000046
491143094,491143094,,0,0,0,0,0,0,0,0,0,0,379,0,0
799977169678192640,799977169678192640,,0,0,0,0,0,0,0,0,0,0,380,0,0
1431627661894471680,1431627661894471680,,0,1,1,0,1,1,1,1,1,0,28,0,0
1351636784854265856,1351636784854265856,,0,1,1,0,1,1,2,0.666667,0.75,0,18,0,0
1430852324,1430852324,,1,1,2,1,1,2,1,1,1,0,18,0,0
1235787038785507328,1235787038785507328,,0,1,1,0,1,1,2,0.518519,0.535714,0,57,0,0.000004
1348996921646575616,1348996921646575616,,0,0,0,0,0,0,0,0,0,0,381,0,0
429344693,429344693,,0,1,1,0,2,2,5,0.449942,0.471782,0,28,0,0.000046
2414699069,2414699069,,0,1,1,0,1,1,1,1,1,0,250,0,0.000003
149609445,149609445,,0,1,1,0,2,2,5,0.449942,0.471782,0,28,0,0.000046
12918562,12918562,,0,1,1,0,1,1,1,1,1,0,37,0,0.003445
1269001889439457280,1269001889439457280,,0,6,6,0,6,6,5,0.455814,0.48057,0,28,0,0.000067
2166381300,2166381300,,1,0,1,1,0,1,0,0,0,0,28,0.000002,0
1364303913273483264,1364303913273483264,,0,2,2,0,2,2,1,1,1,0,15,0,0.000295
134485712,134485712,,3,0,3,3,0,3,0,0,0,0,15,0.000009,0
1522748286,1522748286,,0,0,0,0,0,0,0,0,0,0,382,0,0
1341462944,1341462944,,0,1,1,0,1,1,1,1,1,0,383,0,0
337155946,337155946,,2,0,2,2,0,2,0,0,0,0,383,0,0
1048885219598774272,1048885219598774272,,0,1,1,0,1,1,2,0.666667,0.75,0,28,0,0.00002
433236253,433236253,,0,1,1,0,1,1,1,1,1,0,33,0,0.00003
1519882520,1519882520,,0,1,1,0,1,1,1,1,1,0,15,0,0.000295
3200053252,3200053252,,0,1,1,0,1,1,1,1,1,0,19,0,0
789580133975855104,789580133975855104,,0,1,1,0,1,1,1,1,1,0,383,0,0
1086260624655638528,1086260624655638528,,0,1,1,0,1,1,2,0.666667,0.75,0,21,0,0.000949
494090567,494090567,,0,0,0,0,0,0,0,0,0,0,384,0,0
455912569,455912569,,0,1,1,0,1,1,5,0.449942,0.471782,0,28,0,0.000046
3988651173,3988651173,,0,1,1,0,1,1,1,1,1,0,18,0,0.000018
72286117,72286117,,0,1,1,0,1,1,5,0.449942,0.471782,0,28,0,0.000046
892912476,892912476,,0,1,1,0,1,1,1,1,1,0,19,0,0
899952481,899952481,,0,1,1,0,1,1,1,1,1,0,19,0,0
1121539277597356032,1121539277597356032,,1,0,1,1,0,1,0,0,0,0,57,0,0
871756555,871756555,,0,1,1,0,1,1,3,0.416667,0.5,0,14,0,0
232259622,232259622,,0,1,1,0,2,2,1,1,1,0,385,0,0
707022920,707022920,,1,0,1,2,0,2,0,0,0,0,385,0,0
3547880116,3547880116,,0,2,2,0,2,2,5,0.45098,0.473487,0,28,0,0.000046
586620795,586620795,,0,0,0,0,0,0,0,0,0,0,386,0,0
409448246,409448246,,0,1,1,0,3,3,2,0.666667,0.75,0,387,0,0
3030533474,3030533474,,1,1,2,3,1,4,1,1,1,0,387,0,0
1975677404,1975677404,,0,1,1,0,1,1,1,1,1,0,110,0,0
526838409,526838409,,0,1,1,0,1,1,2,0.666667,0.75,0,21,0,0.000949
3078402187,3078402187,,1,2,3,1,2,3,2,0.75,0.833333,0,14,0,0.019438
411672378,411672378,,1,3,4,1,4,5,1,1,1,0.000001,14,0,0.005053
83326299,83326299,,0,1,1,0,1,1,1,1,1,0,388,0,0
839110337139986432,839110337139986432,,1,0,1,1,0,1,0,0,0,0,388,0,0
1403716536993517568,1403716536993517568,,0,0,0,0,0,0,0,0,0,0,389,0,0
65078688,65078688,,0,1,1,0,1,1,5,0.449942,0.471782,0,28,0,0.000046
1005895812675751936,1005895812675751936,,0,1,1,0,1,1,1,1,1,0,390,0,0
1018058756,1018058756,,1,0,1,1,0,1,0,0,0,0,390,0,0
734083116919365632,734083116919365632,,0,1,1,0,1,1,1,1,1,0,19,0,0
1484817240,1484817240,,0,2,2,0,4,4,3,0.555556,0.666667,0,25,0,0.00002
797184637990764544,797184637990764544,,0,3,3,0,3,3,5,0.451501,0.474766,0,28,0,0.000067
59438709,59438709,,0,1,1,0,1,1,1,1,1,0,33,0,0.00003
826920912335302656,826920912335302656,,0,0,0,0,0,0,0,0,0,0,391,0,0
4619769987,4619769987,,0,1,1,0,1,1,3,0.5,0.611111,0,28,0,0
1112474438065377280,1112474438065377280,,2,1,3,2,1,3,2,0.666667,0.75,0,28,0,0.00002
1442745694700326912,1442745694700326912,,0,3,3,0,3,3,1,1,1,0,9,0,0.002643
1261370864190324736,1261370864190324736,,0,1,1,0,1,1,1,1,1,0,15,0,0.000108
983065508,983065508,,0,3,3,0,4,4,5,0.451613,0.474466,0,28,0,0.00005
701043452,701043452,,0,0,0,0,0,0,0,0,0,0,392,0,0
470543675,470543675,,0,1,1,0,1,1,3,0.5,0.611111,0,28,0,0
1110438806220623872,1110438806220623872,,0,1,1,0,1,1,1,1,1,0,19,0,0
489315920,489315920,,0,1,1,0,1,1,1,1,1,0,28,0,0.000001
4824798082,4824798082,,0,1,1,0,1,1,5,0.449942,0.471782,0,28,0,0.000046
2359548435,2359548435,,0,0,0,0,0,0,0,0,0,0,393,0,0
2623362653,2623362653,,0,1,1,0,2,2,5,0.449942,0.471782,0,28,0,0.000046
328486212,328486212,,0,3,3,0,3,3,2,0.714286,0.8,0,21,0,0
1251862548,1251862548,,1,2,3,1,3,4,1,1,1,0,21,0,0.000001
1272581085814296576,1272581085814296576,,1,0,1,1,0,1,0,0,0,0,21,0,0
350731504,350731504,,1,0,1,1,0,1,0,0,0,0,21,0,0
2600276019,2600276019,,0,0,0,0,0,0,0,0,0,0,394,0,0
1197479584175923200,1197479584175923200,,0,1,1,0,1,1,1,1,1,0,15,0,0.000108
2392944265,2392944265,,0,0,0,0,0,0,0,0,0,0,395,0,0
801895595237670912,801895595237670912,,0,1,1,0,1,1,5,0.449942,0.471782,0,28,0,0.000046
2797440824,2797440824,,0,1,1,0,1,1,1,1,1,0,396,0,0
481523060,481523060,,1,0,1,1,0,1,0,0,0,0,396,0,0
2349902485,2349902485,,0,1,1,0,1,1,5,0.449942,0.471782,0,28,0,0.000046
971075728438710272,971075728438710272,,0,1,1,0,2,2,5,0.449942,0.471782,0,28,0,0.000046
1160890629225951232,1160890629225951232,,0,1,1,0,1,1,1,1,1,0,28,0,0.000001
1305614540554502144,1305614540554502144,,0,0,0,0,0,0,0,0,0,0,397,0,0
2387188576,2387188576,,0,1,1,0,1,1,5,0.449942,0.471782,0,28,0,0.000046
1168797480,1168797480,,0,3,3,0,3,3,5,0.453071,0.475831,0,33,0,0.000065
946683898498514944,946683898498514944,,0,1,1,0,1,1,5,0.449942,0.471782,0,28,0,0.000046
1377438313,1377438313,,0,0,0,0,0,0,0,0,0,0,398,0,0
1022119382,1022119382,,1,0,1,1,0,1,0,0,0,0,15,0,0
1853437622,1853437622,,0,0,0,0,0,0,0,0,0,0,399,0,0
3342659920,3342659920,,0,0,0,0,0,0,0,0,0,0,400,0,0
873255372,873255372,,0,1,1,0,1,1,5,0.449942,0.471782,0,28,0,0.000046
930415257176170496,930415257176170496,,0,2,2,0,3,3,5,0.451501,0.4737,0,28,0,0.0001
1142782223193653248,1142782223193653248,,0,0,0,0,0,0,0,0,0,0,401,0,0
3360214281,3360214281,,0,1,1,0,1,1,2,0.666667,0.75,0,28,0,0.00002
455200915,455200915,,0,1,1,0,2,2,5,0.449942,0.471782,0,28,0,0.000046
1595228996,1595228996,,0,1,1,0,1,1,5,0.449942,0.471782,0,28,0,0.000046
1269002867064651776,1269002867064651776,,0,1,1,0,1,1,2,0.518519,0.535714,0,57,0,0.000004
1010100626,1010100626,,0,1,1,0,1,1,2,0.518519,0.535714,0,57,0,0.000004
1448304343518793728,1448304343518793728,,0,1,1,0,1,1,1,1,1,0,675,0,0
261174847,261174847,,2,0,2,3,0,3,0,0,0,0,675,0,0
1876971385,1876971385,,0,2,2,0,2,2,5,0.45098,0.473487,0,28,0,0.000046
409427594,409427594,,0,3,3,0,4,4,3,0.5,0.555556,0,28,0,0.000004
2359413432,2359413432,,2,0,2,4,0,4,0,0,0,0,21,0,0
462727397,462727397,,0,2,2,0,2,2,2,0.625,0.7,0,250,0,0
2919449735,2919449735,,0,1,1,0,1,1,5,0.449942,0.471782,0,28,0,0.000046
161483639,161483639,,0,1,1,0,1,1,5,0.449942,0.471782,0,28,0,0.000046
568142347,568142347,,1,0,1,1,0,1,0,0,0,0,57,0,0
137397499,137397499,,1,0,1,1,0,1,0,0,0,0,57,0,0
438798142,438798142,,1,0,1,1,0,1,0,0,0,0,57,0,0
1358706639319277568,1358706639319277568,,1,0,1,1,0,1,0,0,0,0,57,0,0
85838534,85838534,,1,0,1,1,0,1,0,0,0,0,57,0,0
463911801,463911801,,1,0,1,1,0,1,0,0,0,0,57,0,0
1208458128523743232,1208458128523743232,,1,0,1,1,0,1,0,0,0,0,57,0,0
1259488258456793088,1259488258456793088,,1,0,1,1,0,1,0,0,0,0,57,0,0
838844506212564992,838844506212564992,,1,0,1,1,0,1,0,0,0,0,57,0,0
61142253,61142253,,1,0,1,1,0,1,0,0,0,0,57,0,0
1202000430479400960,1202000430479400960,,1,0,1,1,0,1,0,0,0,0,57,0,0
225490204,225490204,,1,0,1,1,0,1,0,0,0,0,57,0,0
1416892378850398208,1416892378850398208,,1,0,1,1,0,1,0,0,0,0,57,0,0
1466843276,1466843276,,0,1,1,0,1,1,1,1,1,0,15,0,0.000155
763788442148999168,763788442148999168,,0,0,0,0,0,0,0,0,0,0,402,0,0
3084886731,3084886731,,0,4,4,0,4,4,2,0.7,0.785714,0,57,0,0.001816
1360938668366716928,1360938668366716928,,1,0,1,1,0,1,0,0,0,0,57,0.000053,0
372244024,372244024,,0,2,2,0,2,2,5,0.450575,0.473129,0,28,0,0.000046
1434469082703798272,1434469082703798272,,0,0,0,0,0,0,0,0,0,0,403,0,0
759821659138166784,759821659138166784,,0,1,1,0,1,1,1,1,1,0,28,0,0
866679978,866679978,,0,0,0,0,0,0,0,0,0,0,404,0,0
709020928,709020928,,0,2,2,0,2,2,5,0.45098,0.473487,0,33,0,0.000075
904559376,904559376,,0,1,1,0,1,1,2,0.666667,0.75,0,28,0,0.00002
555195323,555195323,,0,1,1,0,2,2,5,0.449942,0.471782,0,28,0,0.000046
957539562,957539562,,0,0,0,0,0,0,0,0,0,0,405,0,0
444825923,444825923,,1,0,1,1,0,1,0,0,0,0,250,0,0
2174507470,2174507470,,1,0,1,1,0,1,0,0,0,0,250,0,0
494418886,494418886,,0,1,1,0,1,1,5,0.449942,0.471782,0,28,0,0.000046
1357619758473109504,1357619758473109504,,0,1,1,0,1,1,2,0.666667,0.75,0,21,0,0.000949
477942413,477942413,,0,0,0,0,0,0,0,0,0,0,406,0,0
1453663939,1453663939,,0,1,1,0,1,1,5,0.449942,0.471782,0,28,0,0.000046
2002721,2002721,,0,2,2,0,2,2,5,0.45098,0.473487,0,28,0,0.000065
579701946,579701946,,0,1,1,0,1,1,5,0.449942,0.471782,0,28,0,0.000046
815934367,815934367,,0,1,1,0,1,1,1,1,1,0,28,0,0
1528087465,1528087465,,0,1,1,0,1,1,4,0.421053,0.489583,0,15,0,0.000431
296197775,296197775,,0,1,1,0,1,1,1,1,1,0,110,0,0
992686250,992686250,,0,2,2,0,2,2,5,0.450575,0.473129,0,28,0,0.000046
137804256,137804256,,0,1,1,0,1,1,5,0.449942,0.471782,0,28,0,0.000046
50709073,50709073,,0,0,0,0,0,0,0,0,0,0,407,0,0
272642588,272642588,,0,1,1,0,1,1,4,0.421053,0.489583,0,15,0,0.000431
1133004105767694336,1133004105767694336,,0,1,1,0,2,2,5,0.449942,0.471782,0,28,0,0.000046
1384083558814285824,1384083558814285824,,0,1,1,0,2,2,1,1,1,0,408,0,0
1295592542482968576,1295592542482968576,,1,0,1,2,0,2,0,0,0,0,408,0,0
1029690445788590080,1029690445788590080,,1,0,1,1,0,1,0,0,0,0,15,0,0
1147108037204856832,1147108037204856832,,1,0,1,1,0,1,0,0,0,0,15,0,0
1449066675035418624,1449066675035418624,,1,0,1,1,0,1,0,0,0,0,15,0,0
1248557329882271744,1248557329882271744,,1,2,3,1,2,3,2,0.75,0.833333,0.000001,15,0,0.019393
1120683360173658112,1120683360173658112,,0,0,0,0,0,0,0,0,0,0,409,0,0
825458049238368256,825458049238368256,,0,1,1,0,1,1,2,0.666667,0.75,0,21,0,0.000949
1701423990,1701423990,,0,2,2,0,4,4,3,0.469697,0.5,0,28,0,0.000055
1427344518207135744,1427344518207135744,,2,0,2,3,0,3,0,0,0,0,28,0.000001,0
2160731013,2160731013,,1,0,1,3,0,3,0,0,0,0,28,0.000001,0
395218906,395218906,,3,1,4,4,2,6,1,1,1,0.000008,28,0.000001,0
482482833,482482833,,1,0,1,1,0,1,0,0,0,0,28,0.000001,0
425730108,425730108,,1,0,1,1,0,1,0,0,0,0,28,0.000001,0
82090270,82090270,,1,0,1,1,0,1,0,0,0,0,28,0.000001,0
1161193464,1161193464,,1,1,2,1,1,2,1,1,1,0.000004,28,0.000001,0
2401436865,2401436865,,1,0,1,1,0,1,0,0,0,0,28,0.000001,0
403062157,403062157,,1,1,2,1,1,2,1,1,1,0,28,0.000001,0.000002
1384438590390902784,1384438590390902784,,1,0,1,1,0,1,0,0,0,0,28,0.000001,0
1337280565,1337280565,,1,0,1,1,0,1,0,0,0,0,28,0.000001,0
2339797209,2339797209,,1,0,1,1,0,1,0,0,0,0,28,0.000001,0
1168440247685976064,1168440247685976064,,1,0,1,1,0,1,0,0,0,0,28,0.000001,0
714546271650975744,714546271650975744,,1,0,1,1,0,1,0,0,0,0,28,0.000001,0
4294368214,4294368214,,1,0,1,1,0,1,0,0,0,0,28,0.000001,0
3135567601,3135567601,,1,0,1,1,0,1,0,0,0,0,28,0.000001,0
1389244782548033536,1389244782548033536,,1,1,2,1,1,2,1,1,1,0,28,0.000001,0.000002
424185443,424185443,,1,0,1,1,0,1,0,0,0,0,28,0.000001,0
3370007122,3370007122,,1,0,1,1,0,1,0,0,0,0,28,0.000001,0
3546308429,3546308429,,1,0,1,1,0,1,0,0,0,0,28,0.000001,0
825039330842439680,825039330842439680,,1,0,1,1,0,1,0,0,0,0,28,0.000001,0
1353996974375264256,1353996974375264256,,1,0,1,1,0,1,0,0,0,0,28,0.000001,0
881977786554081280,881977786554081280,,1,0,1,1,0,1,0,0,0,0,28,0.000001,0
2933276493,2933276493,,1,0,1,1,0,1,0,0,0,0,28,0.000001,0
1311035209,1311035209,,1,0,1,1,0,1,0,0,0,0,28,0.000001,0
547558786,547558786,,1,0,1,1,0,1,0,0,0,0,28,0.000001,0
452292075,452292075,,1,0,1,1,0,1,0,0,0,0,28,0.000001,0
586680141,586680141,,1,1,2,1,1,2,1,1,1,0,28,0.000001,0.000002
2170310526,2170310526,,1,0,1,1,0,1,0,0,0,0,28,0.000001,0
55205808,55205808,,1,0,1,1,0,1,0,0,0,0,28,0.000001,0
997586305,997586305,,1,0,1,1,0,1,0,0,0,0,28,0.000001,0
475902815,475902815,,1,0,1,1,0,1,0,0,0,0,28,0.000001,0
1042482833007239168,1042482833007239168,,1,2,3,1,2,3,3,0.457143,0.489583,0.000078,28,0.000001,0.000035
4615895837,4615895837,,1,0,1,1,0,1,0,0,0,0,28,0.000001,0
29442185,29442185,,1,0,1,1,0,1,0,0,0,0,28,0.000001,0
391379955,391379955,,1,0,1,1,0,1,0,0,0,0,28,0.000001,0
586539065,586539065,,1,0,1,1,0,1,0,0,0,0,28,0.000001,0
910498398612094976,910498398612094976,,1,0,1,1,0,1,0,0,0,0,28,0.000001,0
480222736,480222736,,1,0,1,1,0,1,0,0,0,0,28,0.000001,0
542464638,542464638,,1,0,1,1,0,1,0,0,0,0,28,0.000001,0
752778294,752778294,,1,0,1,1,0,1,0,0,0,0,28,0.000001,0
1041399934887624704,1041399934887624704,,1,0,1,1,0,1,0,0,0,0,28,0.000001,0
4194288393,4194288393,,1,0,1,1,0,1,0,0,0,0,28,0.000001,0
416469167,416469167,,1,0,1,1,0,1,0,0,0,0,28,0.000001,0
423711068,423711068,,1,0,1,1,0,1,0,0,0,0,28,0.000001,0
46096501,46096501,,1,0,1,1,0,1,0,0,0,0,28,0.000001,0
3006676132,3006676132,,1,0,1,1,0,1,0,0,0,0,28,0.000001,0
1058450247100350464,1058450247100350464,,1,0,1,1,0,1,0,0,0,0,28,0.000001,0
611702280,611702280,,1,0,1,1,0,1,0,0,0,0,28,0.000001,0
1104111213359915008,1104111213359915008,,1,0,1,1,0,1,0,0,0,0,28,0.000001,0
1280243599,1280243599,,1,0,1,1,0,1,0,0,0,0,28,0.000001,0
810711224,810711224,,1,0,1,1,0,1,0,0,0,0,28,0.000001,0
1200599401,1200599401,,1,0,1,1,0,1,0,0,0,0,28,0.000001,0
1084786383414272000,1084786383414272000,,1,0,1,1,0,1,0,0,0,0,28,0.000001,0
16255421,16255421,,1,0,1,1,0,1,0,0,0,0,28,0.000001,0
388572693,388572693,,1,0,1,1,0,1,0,0,0,0,28,0.000001,0
2326256697,2326256697,,1,0,1,1,0,1,0,0,0,0,28,0.000001,0
455729797,455729797,,1,0,1,1,0,1,0,0,0,0,28,0.000001,0
1374408380631052288,1374408380631052288,,1,0,1,1,0,1,0,0,0,0,28,0.000001,0
891546211,891546211,,1,0,1,1,0,1,0,0,0,0,28,0.000001,0
825285918424719360,825285918424719360,,1,0,1,1,0,1,0,0,0,0,28,0.000001,0
2161432543,2161432543,,1,0,1,1,0,1,0,0,0,0,28,0.000001,0
2706605659,2706605659,,1,0,1,1,0,1,0,0,0,0,28,0.000001,0
1324668248902766592,1324668248902766592,,1,0,1,1,0,1,0,0,0,0,28,0.000001,0
1220089860180054016,1220089860180054016,,1,0,1,1,0,1,0,0,0,0,28,0.000001,0
961328636895879168,961328636895879168,,1,0,1,1,0,1,0,0,0,0,28,0.000001,0
792814343570202624,792814343570202624,,1,0,1,1,0,1,0,0,0,0,28,0.000001,0
228772357,228772357,,1,0,1,1,0,1,0,0,0,0,28,0.000001,0
713754689389637632,713754689389637632,,1,1,2,1,1,2,1,1,1,0,28,0.000001,0.000001
1111282470715080704,1111282470715080704,,1,0,1,1,0,1,0,0,0,0,28,0.000001,0
1409949057594937344,1409949057594937344,,1,0,1,1,0,1,0,0,0,0,28,0.000001,0
449754589,449754589,,1,0,1,1,0,1,0,0,0,0,28,0.000001,0
76796490,76796490,,1,0,1,1,0,1,0,0,0,0,28,0.000001,0
1223193014249689088,1223193014249689088,,1,0,1,1,0,1,0,0,0,0,28,0.000001,0
537536062,537536062,,1,0,1,1,0,1,0,0,0,0,28,0.000001,0
2822549948,2822549948,,1,0,1,1,0,1,0,0,0,0,28,0.000001,0
337135931,337135931,,1,0,1,1,0,1,0,0,0,0,28,0.000001,0
520206776,520206776,,1,1,2,1,1,2,1,1,1,0.000004,28,0.000001,0
1111225376,1111225376,,1,0,1,1,0,1,0,0,0,0,28,0.000001,0
1448763822643326976,1448763822643326976,,2,0,2,2,0,2,0,0,0,0,17,0.000001,0
22610875,22610875,,1,0,1,1,0,1,0,0,0,0,28,0.000001,0
307566306,307566306,,1,0,1,1,0,1,0,0,0,0,28,0.000001,0
1416682987,1416682987,,1,0,1,1,0,1,0,0,0,0,28,0.000001,0
1167221053,1167221053,,1,0,1,1,0,1,0,0,0,0,28,0.000001,0
1370355235575717888,1370355235575717888,,1,0,1,1,0,1,0,0,0,0,28,0.000001,0
1353999233695830016,1353999233695830016,,1,0,1,1,0,1,0,0,0,0,28,0.000001,0
1404425479,1404425479,,1,0,1,1,0,1,0,0,0,0,28,0.000001,0
1353652604660834304,1353652604660834304,,1,0,1,1,0,1,0,0,0,0,28,0.000001,0
771911694,771911694,,1,0,1,1,0,1,0,0,0,0,28,0.000001,0
986714714,986714714,,1,1,2,1,1,2,2,0.666667,0.75,0,28,0.000001,0.00002
524453451,524453451,,1,4,5,1,4,5,1,1,1,0.000023,33,0.000001,0.000031
1193704675,1193704675,,1,0,1,1,0,1,0,0,0,0,28,0.000001,0
596713210,596713210,,1,0,1,1,0,1,0,0,0,0,28,0.000001,0
1106181225453142016,1106181225453142016,,1,0,1,1,0,1,0,0,0,0,28,0.000001,0
418135188,418135188,,1,0,1,1,0,1,0,0,0,0,28,0.000001,0
401465326,401465326,,1,0,1,1,0,1,0,0,0,0,28,0.000001,0
3357357341,3357357341,,1,0,1,1,0,1,0,0,0,0,28,0.000001,0
1064232619,1064232619,,1,0,1,1,0,1,0,0,0,0,28,0.000001,0
556978533,556978533,,1,0,1,1,0,1,0,0,0,0,28,0.000001,0
1086222647258697728,1086222647258697728,,1,0,1,1,0,1,0,0,0,0,28,0.000001,0
44691281,44691281,,1,0,1,1,0,1,0,0,0,0,28,0.000001,0
764460277966467072,764460277966467072,,1,0,1,1,0,1,0,0,0,0,28,0.000001,0
3971698161,3971698161,,1,0,1,1,0,1,0,0,0,0,28,0.000001,0
822380676326379520,822380676326379520,,1,0,1,1,0,1,0,0,0,0,28,0.000001,0
1016304660,1016304660,,1,0,1,1,0,1,0,0,0,0,28,0.000001,0
2790105954,2790105954,,1,0,1,1,0,1,0,0,0,0,28,0.000001,0
3258112037,3258112037,,1,0,1,1,0,1,0,0,0,0,28,0.000001,0
1084147453593640960,1084147453593640960,,1,0,1,1,0,1,0,0,0,0,28,0.000001,0
878613406022078464,878613406022078464,,1,1,2,1,1,2,1,1,1,0.000004,28,0.000001,0
478591778,478591778,,1,0,1,1,0,1,0,0,0,0,28,0.000001,0
2958805145,2958805145,,1,0,1,1,0,1,0,0,0,0,28,0.000001,0
58452857,58452857,,1,0,1,1,0,1,0,0,0,0,28,0.000001,0
361517168,361517168,,1,0,1,1,0,1,0,0,0,0,28,0.000001,0
22004738,22004738,,1,2,3,1,2,3,1,1,1,0.000008,28,0.000001,0.00005
1392062767046217728,1392062767046217728,,1,0,1,1,0,1,0,0,0,0,28,0.000001,0
1371163622957846528,1371163622957846528,,1,0,1,1,0,1,0,0,0,0,28,0.000001,0
2820362326,2820362326,,1,0,1,1,0,1,0,0,0,0,28,0.000001,0
1247286475,1247286475,,1,0,1,1,0,1,0,0,0,0,28,0.000001,0
26463965,26463965,,1,0,1,1,0,1,0,0,0,0,28,0.000001,0
4195964895,4195964895,,1,0,1,1,0,1,0,0,0,0,28,0.000001,0
438605103,438605103,,1,0,1,1,0,1,0,0,0,0,28,0.000001,0
1187316736078635008,1187316736078635008,,1,0,1,1,0,1,0,0,0,0,28,0.000001,0
2258955115,2258955115,,1,0,1,1,0,1,0,0,0,0,28,0.000001,0
1337098979335614464,1337098979335614464,,1,0,1,1,0,1,0,0,0,0,28,0.000001,0
976246352148619264,976246352148619264,,1,0,1,1,0,1,0,0,0,0,28,0.000001,0
2842504744,2842504744,,1,0,1,1,0,1,0,0,0,0,28,0.000001,0
522987521,522987521,,1,0,1,1,0,1,0,0,0,0,28,0.000001,0
541692979,541692979,,1,2,3,1,2,3,1,1,1,0.000008,28,0.000001,0.000001
2351430459,2351430459,,1,0,1,1,0,1,0,0,0,0,28,0.000001,0
377272505,377272505,,1,0,1,1,0,1,0,0,0,0,28,0.000001,0
1347228139831906304,1347228139831906304,,1,0,1,1,0,1,0,0,0,0,28,0.000001,0
1099277484,1099277484,,1,0,1,1,0,1,0,0,0,0,28,0.000001,0
158017561,158017561,,1,0,1,1,0,1,0,0,0,0,28,0.000001,0
820167402,820167402,,1,0,1,1,0,1,0,0,0,0,28,0.000001,0
504558008,504558008,,1,0,1,1,0,1,0,0,0,0,28,0.000001,0
417920790,417920790,,1,0,1,1,0,1,0,0,0,0,28,0.000001,0
337505189,337505189,,1,0,1,1,0,1,0,0,0,0,28,0.000001,0
1541162928,1541162928,,1,0,1,1,0,1,0,0,0,0,28,0.000001,0
948561042921148416,948561042921148416,,1,0,1,1,0,1,0,0,0,0,28,0.000001,0
205403858,205403858,,1,1,2,1,1,2,1,1,1,0,28,0.000001,0.000002
278646433,278646433,,1,0,1,1,0,1,0,0,0,0,28,0.000001,0
483051922,483051922,,1,0,1,1,0,1,0,0,0,0,28,0.000001,0
3020153968,3020153968,,1,0,1,1,0,1,0,0,0,0,28,0.000001,0
1340223759526014976,1340223759526014976,,1,0,1,1,0,1,0,0,0,0,28,0.000001,0
1274906077,1274906077,,1,0,1,1,0,1,0,0,0,0,28,0.000001,0
631072963,631072963,,1,0,1,1,0,1,0,0,0,0,28,0.000001,0
463686223,463686223,,1,0,1,1,0,1,0,0,0,0,28,0.000001,0
32853295,32853295,,1,0,1,1,0,1,0,0,0,0,28,0.000001,0
2207177382,2207177382,,1,0,1,1,0,1,0,0,0,0,28,0.000001,0
48451670,48451670,,1,0,1,1,0,1,0,0,0,0,28,0.000001,0
25477483,25477483,,1,0,1,1,0,1,0,0,0,0,28,0.000001,0
1033005823,1033005823,,1,0,1,1,0,1,0,0,0,0,28,0.000001,0
903166269339443200,903166269339443200,,1,0,1,1,0,1,0,0,0,0,28,0.000001,0
977290488528109568,977290488528109568,,1,1,2,1,1,2,1,1,1,0.000008,28,0.000001,0
703956848836222976,703956848836222976,,1,0,1,1,0,1,0,0,0,0,28,0.000001,0
2412895226,2412895226,,1,0,1,1,0,1,0,0,0,0,28,0.000001,0
1247558843955064832,1247558843955064832,,1,0,1,1,0,1,0,0,0,0,28,0.000001,0
975470051263434752,975470051263434752,,1,0,1,1,0,1,0,0,0,0,28,0.000001,0
1212496150332227584,1212496150332227584,,1,0,1,1,0,1,0,0,0,0,28,0.000001,0
22610221,22610221,,1,2,3,1,2,3,1,1,1,0,28,0.000001,0.000021
286543,286543,,1,0,1,1,0,1,0,0,0,0,28,0.000001,0
2976098387,2976098387,,1,0,1,1,0,1,0,0,0,0,28,0.000001,0
428401163,428401163,,1,0,1,1,0,1,0,0,0,0,28,0.000001,0
2447213385,2447213385,,1,0,1,1,0,1,0,0,0,0,28,0.000001,0
765974953925771264,765974953925771264,,1,0,1,1,0,1,0,0,0,0,28,0.000001,0
477734625,477734625,,1,0,1,1,0,1,0,0,0,0,28,0.000001,0
1117145216753049600,1117145216753049600,,1,0,1,1,0,1,0,0,0,0,28,0.000001,0
2996797988,2996797988,,1,0,1,1,0,1,0,0,0,0,28,0.000001,0
947015537808281600,947015537808281600,,1,0,1,1,0,1,0,0,0,0,28,0.000001,0
986569138251452416,986569138251452416,,1,0,1,1,0,1,0,0,0,0,28,0.000001,0
709356879093358592,709356879093358592,,1,0,1,1,0,1,0,0,0,0,28,0.000001,0
2880084795,2880084795,,1,0,1,1,0,1,0,0,0,0,28,0.000001,0
1372480342880309248,1372480342880309248,,1,0,1,1,0,1,0,0,0,0,28,0.000001,0
1298969137239281664,1298969137239281664,,1,0,1,1,0,1,0,0,0,0,28,0.000001,0
594652869,594652869,,1,0,1,1,0,1,0,0,0,0,28,0.000001,0
1277878552868925440,1277878552868925440,,1,0,1,1,0,1,0,0,0,0,28,0.000001,0
1390254751,1390254751,,1,0,1,1,0,1,0,0,0,0,28,0.000001,0
464030854,464030854,,1,0,1,1,0,1,0,0,0,0,28,0.000001,0
841335204,841335204,,1,0,1,1,0,1,0,0,0,0,28,0.000001,0
593966072,593966072,,1,0,1,1,0,1,0,0,0,0,28,0.000001,0
400210083,400210083,,1,0,1,1,0,1,0,0,0,0,28,0.000001,0
2957474795,2957474795,,1,1,2,1,1,2,1,1,1,0,28,0.000001,0.000001
1070568928378789888,1070568928378789888,,1,0,1,1,0,1,0,0,0,0,28,0.000001,0
152766443,152766443,,1,0,1,1,0,1,0,0,0,0,28,0.000001,0
1241666558667169792,1241666558667169792,,1,0,1,1,0,1,0,0,0,0,28,0.000001,0
1073080100,1073080100,,1,0,1,1,0,1,0,0,0,0,28,0.000001,0
2359069146,2359069146,,1,0,1,1,0,1,0,0,0,0,28,0.000001,0
2611468966,2611468966,,1,0,1,1,0,1,0,0,0,0,28,0.000001,0
1368793633,1368793633,,1,1,2,1,1,2,2,0.666667,0.75,0.000016,28,0.000001,0
1267205780,1267205780,,1,0,1,1,0,1,0,0,0,0,28,0.000001,0
1387056339591991296,1387056339591991296,,1,0,1,1,0,1,0,0,0,0,28,0.000001,0
2341383591,2341383591,,1,0,1,1,0,1,0,0,0,0,28,0.000001,0
957610462815965184,957610462815965184,,1,0,1,1,0,1,0,0,0,0,28,0.000001,0
133998087,133998087,,1,0,1,1,0,1,0,0,0,0,28,0.000001,0
3073333545,3073333545,,1,0,1,1,0,1,0,0,0,0,28,0.000001,0
405125113,405125113,,1,0,1,1,0,1,0,0,0,0,28,0.000001,0
624547168,624547168,,1,0,1,1,0,1,0,0,0,0,28,0.000001,0
132171535,132171535,,1,0,1,1,0,1,0,0,0,0,28,0.000001,0
1603331444,1603331444,,1,0,1,1,0,1,0,0,0,0,28,0.000001,0
450036157,450036157,,1,0,1,1,0,1,0,0,0,0,28,0.000001,0
924067784,924067784,,1,0,1,1,0,1,0,0,0,0,28,0.000001,0
272354189,272354189,,1,0,1,1,0,1,0,0,0,0,28,0.000001,0
3295272815,3295272815,,1,0,1,1,0,1,0,0,0,0,28,0.000001,0
885795917865136128,885795917865136128,,1,0,1,1,0,1,0,0,0,0,28,0.000001,0
1001512865860341760,1001512865860341760,,1,0,1,1,0,1,0,0,0,0,28,0.000001,0
3407665319,3407665319,,1,0,1,1,0,1,0,0,0,0,28,0.000001,0
1296100808136839168,1296100808136839168,,1,0,1,1,0,1,0,0,0,0,28,0.000001,0
2888908630,2888908630,,1,0,1,1,0,1,0,0,0,0,28,0.000001,0
470275854,470275854,,1,0,1,1,0,1,0,0,0,0,28,0.000001,0
953548088,953548088,,1,0,1,1,0,1,0,0,0,0,28,0.000001,0
3042840742,3042840742,,1,0,1,1,0,1,0,0,0,0,28,0.000001,0
2950650945,2950650945,,1,0,1,1,0,1,0,0,0,0,28,0.000001,0
976598371,976598371,,1,0,1,1,0,1,0,0,0,0,28,0.000001,0
1064517730542473216,1064517730542473216,,1,1,2,1,1,2,1,1,1,0,28,0.000001,0.000002
1135427762,1135427762,,1,0,1,1,0,1,0,0,0,0,28,0.000001,0
5404582,5404582,,1,0,1,1,0,1,0,0,0,0,28,0.000001,0
1130471154190303232,1130471154190303232,,1,0,1,1,0,1,0,0,0,0,28,0.000001,0
971432653923799040,971432653923799040,,1,0,1,1,0,1,0,0,0,0,28,0.000001,0
468782303,468782303,,1,0,1,1,0,1,0,0,0,0,28,0.000001,0
415590175,415590175,,1,0,1,1,0,1,0,0,0,0,28,0.000001,0
1545817196,1545817196,,1,0,1,1,0,1,0,0,0,0,28,0.000001,0
2347295390,2347295390,,1,0,1,1,0,1,0,0,0,0,28,0.000001,0
826804529400254464,826804529400254464,,1,1,2,1,1,2,1,1,1,0.000008,28,0.000001,0
427626319,427626319,,1,0,1,1,0,1,0,0,0,0,28,0.000001,0
1628760746,1628760746,,1,0,1,1,0,1,0,0,0,0,28,0.000001,0
955160253263437824,955160253263437824,,1,0,1,1,0,1,0,0,0,0,28,0.000001,0
526327701,526327701,,1,0,1,1,0,1,0,0,0,0,28,0.000001,0
1252902122745626624,1252902122745626624,,1,0,1,1,0,1,0,0,0,0,28,0.000001,0
898287332,898287332,,1,0,1,1,0,1,0,0,0,0,28,0.000001,0
837338667425411072,837338667425411072,,1,0,1,1,0,1,0,0,0,0,28,0.000001,0
45413247,45413247,,1,0,1,2,0,2,0,0,0,0,28,0.000001,0
695753,695753,,2,0,2,4,0,4,0,0,0,0,28,0.000001,0
2362415546,2362415546,,1,0,1,1,0,1,0,0,0,0,28,0.000001,0
733371908750708736,733371908750708736,,1,1,2,1,1,2,1,1,1,0,28,0.000001,0.000001
297876654,297876654,,1,0,1,1,0,1,0,0,0,0,28,0.000001,0
819652946,819652946,,1,1,2,1,1,2,1,1,1,0,28,0.000001,0.000001
96779870,96779870,,1,0,1,1,0,1,0,0,0,0,28,0.000001,0
701033903595847680,701033903595847680,,1,0,1,1,0,1,0,0,0,0,28,0.000001,0
593519995,593519995,,2,1,3,2,1,3,1,1,1,0.000001,28,0.000001,0.000002
1068376968343838720,1068376968343838720,,1,0,1,1,0,1,0,0,0,0,28,0.000001,0
982403090,982403090,,1,0,1,1,0,1,0,0,0,0,28,0.000001,0
1229377915,1229377915,,1,0,1,1,0,1,0,0,0,0,28,0.000001,0
397508253,397508253,,1,0,1,1,0,1,0,0,0,0,28,0.000001,0
2786004480,2786004480,,1,1,2,1,1,2,1,1,1,0,28,0.000001,0
1418901198,1418901198,,1,0,1,1,0,1,0,0,0,0,28,0.000001,0
3014575779,3014575779,,1,0,1,1,0,1,0,0,0,0,28,0.000001,0
2999929357,2999929357,,1,1,2,1,1,2,1,1,1,0.000006,110,0.000001,0.000001
1098245892,1098245892,,1,0,1,1,0,1,0,0,0,0,28,0.000001,0
1196488081114894336,1196488081114894336,,1,0,1,1,0,1,0,0,0,0,28,0.000001,0
2289505911,2289505911,,1,0,1,1,0,1,0,0,0,0,28,0.000001,0
1104424837,1104424837,,1,0,1,1,0,1,0,0,0,0,28,0.000001,0
313304046,313304046,,1,0,1,1,0,1,0,0,0,0,28,0.000001,0
1098510936879624192,1098510936879624192,,1,0,1,1,0,1,0,0,0,0,28,0.000001,0
959192415428120576,959192415428120576,,1,1,2,1,1,2,1,1,1,0,28,0.000001,0.000001
2587222616,2587222616,,1,0,1,1,0,1,0,0,0,0,28,0.000001,0
291763976,291763976,,1,0,1,1,0,1,0,0,0,0,28,0.000001,0
394555285,394555285,,1,0,1,1,0,1,0,0,0,0,28,0.000001,0
245493432,245493432,,1,0,1,1,0,1,0,0,0,0,28,0.000001,0
1254384198946783232,1254384198946783232,,1,0,1,1,0,1,0,0,0,0,28,0.000001,0
2263023126,2263023126,,1,0,1,1,0,1,0,0,0,0,28,0.000001,0
351678178,351678178,,1,0,1,1,0,1,0,0,0,0,28,0.000001,0
1186918640425328640,1186918640425328640,,2,0,2,2,0,2,0,0,0,0,28,0.000001,0
1912288435,1912288435,,1,1,2,1,1,2,1,1,1,0,28,0.000001,0.000001
4601698335,4601698335,,1,0,1,1,0,1,0,0,0,0,28,0.000001,0
2983119910,2983119910,,1,0,1,1,0,1,0,0,0,0,28,0.000001,0
2388598743,2388598743,,1,0,1,1,0,1,0,0,0,0,28,0.000001,0
1016189311,1016189311,,1,0,1,1,0,1,0,0,0,0,28,0.000001,0
424355891,424355891,,1,1,2,1,1,2,2,0.666667,0.75,0,28,0.000001,0.00002
1035648571163521024,1035648571163521024,,1,2,3,1,3,4,3,0.460674,0.487805,0.00015,28,0.000001,0.000035
746773661835747328,746773661835747328,,1,0,1,1,0,1,0,0,0,0,28,0.000001,0
220780313,220780313,,1,0,1,1,0,1,0,0,0,0,28,0.000001,0
908731428124397568,908731428124397568,,1,0,1,1,0,1,0,0,0,0,28,0.000001,0
1184104489453850624,1184104489453850624,,1,0,1,1,0,1,0,0,0,0,28,0.000001,0
1267531441367326720,1267531441367326720,,1,0,1,1,0,1,0,0,0,0,28,0.000001,0
2347350496,2347350496,,1,0,1,1,0,1,0,0,0,0,28,0.000001,0
981430933269241856,981430933269241856,,2,0,2,2,0,2,0,0,0,0,28,0.000001,0
2964119115,2964119115,,1,0,1,1,0,1,0,0,0,0,28,0.000001,0
140171566,140171566,,1,0,1,1,0,1,0,0,0,0,28,0.000001,0
437811348,437811348,,1,0,1,1,0,1,0,0,0,0,28,0.000001,0
4441755699,4441755699,,1,0,1,1,0,1,0,0,0,0,28,0.000001,0
4787676166,4787676166,,1,0,1,1,0,1,0,0,0,0,28,0.000001,0
318615150,318615150,,1,0,1,1,0,1,0,0,0,0,28,0.000001,0
1225696746,1225696746,,1,1,2,1,1,2,1,1,1,0.000008,28,0.000001,0
635445777,635445777,,1,0,1,1,0,1,0,0,0,0,28,0.000001,0
1146000671038222336,1146000671038222336,,1,0,1,1,0,1,0,0,0,0,28,0.000001,0
983351833,983351833,,1,0,1,1,0,1,0,0,0,0,28,0.000001,0
96582467,96582467,,1,0,1,1,0,1,0,0,0,0,28,0.000001,0
2470471315,2470471315,,1,1,2,1,1,2,2,0.666667,0.75,0.00001,33,0.000001,0
396838769,396838769,,1,0,1,1,0,1,0,0,0,0,28,0.000001,0
495412522,495412522,,1,1,2,1,1,2,1,1,1,0,28,0.000001,0.000002
247220408,247220408,,1,0,1,1,0,1,0,0,0,0,28,0.000001,0
85113254,85113254,,1,0,1,1,0,1,0,0,0,0,28,0.000001,0
399307522,399307522,,1,0,1,1,0,1,0,0,0,0,28,0.000001,0
486822096,486822096,,1,0,1,1,0,1,0,0,0,0,28,0.000001,0
781383422484897792,781383422484897792,,1,0,1,1,0,1,0,0,0,0,28,0.000001,0
1324779876327579648,1324779876327579648,,1,0,1,1,0,1,0,0,0,0,28,0.000001,0
2384025086,2384025086,,1,0,1,1,0,1,0,0,0,0,28,0.000001,0
1230971096821829632,1230971096821829632,,1,0,1,1,0,1,0,0,0,0,28,0.000001,0
236939562,236939562,,1,1,2,1,1,2,1,1,1,0.000004,28,0.000001,0.00005
358222474,358222474,,1,0,1,1,0,1,0,0,0,0,28,0.000001,0
977497926,977497926,,1,0,1,1,0,1,0,0,0,0,28,0.000001,0
1051904650897698816,1051904650897698816,,1,0,1,1,0,1,0,0,0,0,28,0.000001,0
2823571467,2823571467,,1,0,1,1,0,1,0,0,0,0,28,0.000001,0
1238080592618676224,1238080592618676224,,1,0,1,1,0,1,0,0,0,0,28,0.000001,0
1340625284081594368,1340625284081594368,,1,0,1,1,0,1,0,0,0,0,28,0.000001,0
1344021517517119488,1344021517517119488,,1,0,1,1,0,1,0,0,0,0,28,0.000001,0
223215480,223215480,,1,0,1,1,0,1,0,0,0,0,28,0.000001,0
2781204699,2781204699,,1,0,1,1,0,1,0,0,0,0,28,0.000001,0
1256647827708620800,1256647827708620800,,1,0,1,1,0,1,0,0,0,0,28,0.000001,0
1359985765,1359985765,,1,0,1,1,0,1,0,0,0,0,28,0.000001,0
418301345,418301345,,1,0,1,1,0,1,0,0,0,0,28,0.000001,0
803696299354849280,803696299354849280,,1,0,1,1,0,1,0,0,0,0,28,0.000001,0
2626944704,2626944704,,1,0,1,1,0,1,0,0,0,0,28,0.000001,0
136026464,136026464,,1,0,1,1,0,1,0,0,0,0,28,0.000001,0
925688759450038272,925688759450038272,,1,0,1,1,0,1,0,0,0,0,28,0.000001,0
84545911,84545911,,1,0,1,1,0,1,0,0,0,0,28,0.000001,0
1273484769276370944,1273484769276370944,,1,0,1,1,0,1,0,0,0,0,28,0.000001,0
47710288,47710288,,2,0,2,2,0,2,0,0,0,0,28,0.000001,0
440737015,440737015,,2,0,2,2,0,2,0,0,0,0,28,0.000001,0
513094624,513094624,,1,0,1,1,0,1,0,0,0,0,28,0.000001,0
977300337316061184,977300337316061184,,1,0,1,1,0,1,0,0,0,0,28,0.000001,0
23774462,23774462,,1,0,1,1,0,1,0,0,0,0,28,0.000001,0
1221563242977419264,1221563242977419264,,1,0,1,1,0,1,0,0,0,0,28,0.000001,0
971478762100613120,971478762100613120,,1,0,1,1,0,1,0,0,0,0,28,0.000001,0
1362578334,1362578334,,1,0,1,1,0,1,0,0,0,0,28,0.000001,0
1530871844,1530871844,,1,0,1,1,0,1,0,0,0,0,28,0.000001,0
1357710228,1357710228,,1,0,1,1,0,1,0,0,0,0,28,0.000001,0
747112645757665280,747112645757665280,,1,0,1,1,0,1,0,0,0,0,28,0.000001,0
1350555810909327360,1350555810909327360,,1,0,1,1,0,1,0,0,0,0,28,0.000001,0
317951602,317951602,,1,1,2,1,1,2,1,1,1,0.000008,28,0.000001,0
2435638248,2435638248,,1,0,1,1,0,1,0,0,0,0,28,0.000001,0
457608453,457608453,,1,0,1,1,0,1,0,0,0,0,28,0.000001,0
114449712,114449712,,1,0,1,1,0,1,0,0,0,0,28,0.000001,0
488617332,488617332,,1,0,1,1,0,1,0,0,0,0,28,0.000001,0
2259216822,2259216822,,0,0,0,0,0,0,0,0,0,0,410,0,0
2984681921,2984681921,,0,1,1,0,1,1,1,1,1,0,15,0,0.001469
36679413,36679413,,0,0,0,0,0,0,0,0,0,0,411,0,0
1447782693593395200,1447782693593395200,,0,0,0,0,0,0,0,0,0,0,412,0,0
4894548701,4894548701,,0,1,1,0,1,1,1,1,1,0,413,0,0
3978683129,3978683129,,1,0,1,1,0,1,0,0,0,0,413,0,0
50671751,50671751,,0,0,0,0,0,0,0,0,0,0,414,0,0
447452303,447452303,,0,2,2,0,2,2,2,0.75,0.833333,0,15,0,0.018314
1082984088,1082984088,,0,2,2,0,3,3,3,0.526316,0.583333,0,9,0,0.000001
2171028731,2171028731,,1,1,2,1,1,2,1,1,1,0,28,0,0
81889184,81889184,,0,0,0,0,0,0,0,0,0,0,415,0,0
349642471,349642471,,0,1,1,0,1,1,1,1,1,0,21,0,0.000866
993253494055456768,993253494055456768,,0,0,0,0,0,0,0,0,0,0,416,0,0
2475394267,2475394267,,0,0,0,0,0,0,0,0,0,0,417,0,0
429310991,429310991,,0,0,0,0,0,0,0,0,0,0,418,0,0
1159347602053324800,1159347602053324800,,0,1,1,0,1,1,1,1,1,0,419,0,0
1201756713117982720,1201756713117982720,,2,0,2,2,0,2,0,0,0,0,419,0,0
2995398629,2995398629,,0,1,1,0,1,1,1,1,1,0,15,0,0.000295
1121265637,1121265637,,0,2,2,0,2,2,2,0.75,0.833333,0,15,0,0.018219
464127310,464127310,,0,1,1,0,1,1,3,0.485714,0.509804,0,17,0,0
1254549042438291456,1254549042438291456,,0,1,1,0,1,1,1,1,1,0,37,0,0.003445
1388834030876041216,1388834030876041216,,0,1,1,0,1,1,2,0.666667,0.75,0,13,0,0.017924
547247951,547247951,,0,1,1,0,1,1,2,0.666667,0.75,0,21,0,0.000949
836585285991424000,836585285991424000,,0,1,1,0,1,1,3,0.485714,0.509804,0,17,0,0
2953821393,2953821393,,0,2,2,0,2,2,2,0.75,0.833333,0,37,0,0.00004
3304016343,3304016343,,0,1,1,0,1,1,1,1,1,0,25,0,0.00062
442817553,442817553,,0,6,6,0,11,11,1,1,1,0,304,0,0
3241806322,3241806322,,1,0,1,2,0,2,0,0,0,0,304,0,0
1392062833119178752,1392062833119178752,,1,0,1,2,0,2,0,0,0,0,304,0,0
496437886,496437886,,1,0,1,2,0,2,0,0,0,0,304,0,0
333410580,333410580,,1,0,1,2,0,2,0,0,0,0,304,0,0
13294452,13294452,,1,0,1,2,0,2,0,0,0,0,304,0,0
342155606,342155606,,0,1,1,0,2,2,1,1,1,0,343,0,0
1168311640405749760,1168311640405749760,,0,1,1,0,1,1,1,1,1,0,37,0,0.003445
423703326,423703326,,0,1,1,0,1,1,1,1,1,0,28,0,0
479569415,479569415,,0,1,1,0,1,1,1,1,1,0,37,0,0.003445
2404216681,2404216681,,0,1,1,0,1,1,1,1,1,0,420,0,0
1444308358199189504,1444308358199189504,,1,0,1,1,0,1,0,0,0,0,420,0,0
1421443456170352640,1421443456170352640,,1,0,1,2,0,2,0,0,0,0,57,0,0
326316197,326316197,,1,0,1,2,0,2,0,0,0,0,57,0,0
252516769,252516769,,1,0,1,2,0,2,0,0,0,0,57,0,0
1099615236,1099615236,,0,1,1,0,1,1,1,1,1,0,28,0,0.000001
1369320696,1369320696,,0,1,1,0,1,1,1,1,1,0,33,0,0.00003
1926958856,1926958856,,0,1,1,0,1,1,2,0.666667,0.75,0,21,0,0.000949
1424957299,1424957299,,0,1,1,0,2,2,1,1,1,0,421,0,0
1057219579200618496,1057219579200618496,,1,0,1,2,0,2,0,0,0,0,421,0,0
1066788384574722048,1066788384574722048,,0,1,1,0,1,1,1,1,1,0,422,0,0
928655470054838272,928655470054838272,,1,0,1,1,0,1,0,0,0,0,422,0,0
2336284753,2336284753,,0,1,1,0,1,1,1,1,1,0,37,0,0.003445
3879187997,3879187997,,0,2,2,0,2,2,3,0.469697,0.5,0,28,0,0.000055
1909044948,1909044948,,0,1,1,0,1,1,3,0.449275,0.473118,0,28,0,0.000035
418361902,418361902,,0,1,1,0,1,1,2,0.666667,0.75,0,28,0,0.00002
1073697036816576512,1073697036816576512,,0,1,1,0,1,1,2,0.666667,0.75,0,13,0,0.017924
1140549974624821248,1140549974624821248,,0,1,1,0,1,1,2,0.666667,0.75,0,28,0,0.00002
203911305,203911305,,0,1,1,0,1,1,4,0.46875,0.491667,0,14,0,0.001002
47471151,47471151,,0,1,1,0,1,1,3,0.5,0.537037,0,15,0,0.000348
1206211060061147136,1206211060061147136,,0,0,0,0,0,0,0,0,0,0,423,0,0
1289586998697701376,1289586998697701376,,0,0,0,0,0,0,0,0,0,0,424,0,0
1354101320224026624,1354101320224026624,,0,1,1,0,1,1,1,1,1,0,13,0,0.000031
1077370538,1077370538,,0,1,1,0,1,1,1,1,1,0,37,0,0.003445
1440626265149501440,1440626265149501440,,0,1,1,0,1,1,1,1,1,0,37,0,0.003445
820311982125498368,820311982125498368,,0,1,1,0,1,1,2,0.666667,0.75,0,704,0,0
1282404747467804672,1282404747467804672,,1,1,2,1,2,3,1,1,1,0,704,0,0
3433322345,3433322345,,0,1,1,0,1,1,2,0.666667,0.75,0,28,0,0.00002
199632783,199632783,,0,1,1,0,1,1,2,0.666667,0.75,0,21,0,0.000111
219482290,219482290,,0,1,1,0,1,1,4,0.46875,0.491667,0,14,0,0.001002
977844595,977844595,,0,1,1,0,1,1,2,0.666667,0.75,0,21,0,0.000949
541787569,541787569,,0,1,1,0,1,1,4,0.46875,0.491667,0,14,0,0.001002
1399769068912230400,1399769068912230400,,0,0,0,0,0,0,0,0,0,0,425,0,0
55026293,55026293,,0,1,1,0,1,1,2,0.666667,0.75,0,13,0,0.00002
1380548448626339840,1380548448626339840,,0,1,1,0,1,1,2,0.666667,0.75,0,13,0,0.017924
1858048118,1858048118,,0,2,2,0,2,2,1,1,1,0,5,0,0.003448
455584716,455584716,,0,1,1,0,1,1,1,1,1,0,28,0,0.000001
1424689315,1424689315,,0,1,1,0,1,1,2,0.666667,0.75,0,21,0,0.000949
4393119563,4393119563,,0,0,0,0,0,0,0,0,0,0,426,0,0
394688429,394688429,,0,1,1,0,1,1,1,1,1,0,28,0,0
1734443700,1734443700,,0,0,0,0,0,0,0,0,0,0,427,0,0
4876992285,4876992285,,0,1,1,0,1,1,3,0.449275,0.473118,0,28,0,0.000035
446964129,446964129,,0,1,1,0,1,1,1,1,1,0,28,0,0
1445286816093986816,1445286816093986816,,0,1,1,0,1,1,1,1,1,0,15,0,0.00015
1411456462430343168,1411456462430343168,,0,0,0,0,0,0,0,0,0,0,428,0,0
203523677,203523677,,0,0,0,0,0,0,0,0,0,0,429,0,0
1084419894949625856,1084419894949625856,,0,3,3,0,3,3,1,1,1,0,21,0,0.005259
1160479665129234432,1160479665129234432,,0,1,1,0,1,1,2,0.666667,0.75,0,21,0,0.000949
801766317028245504,801766317028245504,,0,1,1,0,1,1,1,1,1,0,14,0,0.000019
1439223679431368704,1439223679431368704,,0,0,0,0,0,0,0,0,0,0,430,0,0
27193036,27193036,,0,0,0,0,0,0,0,0,0,0,431,0,0
3246888508,3246888508,,0,1,1,0,1,1,1,1,1,0,15,0,0.001469
1160196692135821312,1160196692135821312,,0,2,2,0,2,2,1,1,1,0,21,0,0.001814
808967944285913088,808967944285913088,,0,1,1,0,1,1,1,1,1,0,9,0,0.00005
171941344,171941344,,0,1,1,0,1,1,1,1,1,0,33,0,0.00003
1175313651974246400,1175313651974246400,,0,1,1,0,1,1,2,0.666667,0.75,0,21,0,0.000949
72811720,72811720,,0,0,0,0,0,0,0,0,0,0,432,0,0
470572668,470572668,,0,1,1,0,1,1,1,1,1,0,37,0,0.003445
525862024,525862024,,0,1,1,0,1,1,1,1,1,0,33,0,0.00003
347844883,347844883,,0,1,1,0,2,2,3,0.449275,0.473118,0,28,0,0.000035
797018318,797018318,,0,1,1,0,1,1,1,1,1,0,18,0,0.00002
595306303,595306303,,0,1,1,0,1,1,1,1,1,0,433,0,0
377249170,377249170,,1,0,1,1,0,1,0,0,0,0,433,0,0
2248600961,2248600961,,0,1,1,0,1,1,1,1,1,0,28,0,0.000001
444072365,444072365,,0,1,1,0,1,1,3,0.449275,0.473118,0,28,0,0.000035
2231602424,2231602424,,0,1,1,0,1,1,3,0.449275,0.473118,0,28,0,0.000035
198600936,198600936,,0,1,1,0,1,1,3,0.449275,0.473118,0,28,0,0.000035
1325373512,1325373512,,0,1,1,0,1,1,2,0.666667,0.75,0,28,0,0.00002
816254841785815040,816254841785815040,,0,2,2,0,2,2,2,0.75,0.833333,0,28,0,0.00095
3432917757,3432917757,,0,1,1,0,1,1,2,0.666667,0.75,0,441,0,0
585977150,585977150,,1,1,2,1,2,3,1,1,1,0,441,0,0
2627013992,2627013992,,0,1,1,0,1,1,3,0.444444,0.5,0,18,0,0.000308
1267931877261926400,1267931877261926400,,0,1,1,0,1,1,1,1,1,0,250,0,0.000003
3066089278,3066089278,,0,1,1,0,1,1,2,0.666667,0.75,0,13,0,0.017924
81432464,81432464,,0,1,1,0,1,1,3,0.449275,0.473118,0,28,0,0.000035
247165787,247165787,,1,1,2,1,2,3,1,1,1,0,17,0,0
1445362748821544960,1445362748821544960,,1,1,2,1,1,2,1,1,1,0,17,0,0.000054
1370111919789596672,1370111919789596672,,1,0,1,1,0,1,0,0,0,0,17,0,0
1251226101713702912,1251226101713702912,,1,0,1,1,0,1,0,0,0,0,17,0,0
1011884485196042240,1011884485196042240,,1,0,1,1,0,1,0,0,0,0,17,0,0
714896919349346304,714896919349346304,,1,0,1,1,0,1,0,0,0,0,17,0,0
1362170430,1362170430,,2,0,2,3,0,3,0,0,0,0,17,0,0
1077645232248889344,1077645232248889344,,1,0,1,1,0,1,0,0,0,0,17,0,0
4405882043,4405882043,,1,0,1,1,0,1,0,0,0,0,17,0,0
3315615891,3315615891,,1,0,1,1,0,1,0,0,0,0,17,0,0
176852142,176852142,,1,0,1,1,0,1,0,0,0,0,17,0,0
3053183649,3053183649,,1,1,2,1,1,2,1,1,1,0,17,0,0.000001
1319293873,1319293873,,1,0,1,1,0,1,0,0,0,0,17,0,0
1168974246,1168974246,,0,1,1,0,1,1,3,0.449275,0.473118,0,28,0,0.000035
422125562,422125562,,0,1,1,0,1,1,1,1,1,0,28,0,0.000001
16770004,16770004,,0,1,1,0,1,1,3,0.449275,0.473118,0,28,0,0.000035
1735223353,1735223353,,0,1,1,0,1,1,2,0.666667,0.75,0,13,0,0
1269377600511754240,1269377600511754240,,2,1,3,2,1,3,1,1,1,0,13,0,0.000001
566428916,566428916,,0,1,1,0,1,1,2,0.666667,0.75,0,21,0,0.000949
1037097032,1037097032,,0,1,1,0,1,1,1,1,1,0,14,0,0.001513
1445315911293054976,1445315911293054976,,0,1,1,0,1,1,3,0.449275,0.473118,0,28,0,0.000035
1222676508,1222676508,,0,1,1,0,1,1,1,1,1,0,434,0,0
1007744827,1007744827,,2,0,2,2,0,2,0,0,0,0,434,0,0
385897719,385897719,,0,1,1,0,1,1,1,1,1,0,435,0,0
1106966297236172800,1106966297236172800,,1,0,1,1,0,1,0,0,0,0,435,0,0
1191791348380254208,1191791348380254208,,0,1,1,0,1,1,3,0.449275,0.473118,0,28,0,0.000035
1231589951671803904,1231589951671803904,,1,0,1,1,0,1,0,0,0,0,15,0,0
2948783698,2948783698,,1,0,1,1,0,1,0,0,0,0,15,0,0
1920245191,1920245191,,1,0,1,1,0,1,0,0,0,0,15,0,0
579103333,579103333,,1,1,2,1,1,2,1,1,1,0,15,0,0.003445
4545085227,4545085227,,1,0,1,2,0,2,0,0,0,0,15,0,0
241300113,241300113,,1,0,1,1,0,1,0,0,0,0,15,0,0
2885454100,2885454100,,0,1,1,0,1,1,4,0.435897,0.47549,0,28,0,0.000004
970835599,970835599,,0,1,1,0,1,1,3,0.449275,0.473118,0,28,0,0.000035
368956290,368956290,,0,2,2,0,2,2,3,0.457143,0.489583,0,18,0,0.000035
104744629,104744629,,0,1,1,0,1,1,1,1,1,0,28,0,0.00005
1254862259735715840,1254862259735715840,,0,1,1,0,1,1,2,0.666667,0.75,0,28,0,0
703512296388222976,703512296388222976,,0,0,0,0,0,0,0,0,0,0,436,0,0
631840181,631840181,,0,0,0,0,0,0,0,0,0,0,437,0,0
1273265383,1273265383,,0,1,1,0,1,1,1,1,1,0,37,0,0.003445
311568240,311568240,,0,1,1,0,1,1,1,1,1,0,37,0,0.003445
1441062315290505216,1441062315290505216,,0,0,0,0,0,0,0,0,0,0,438,0,0
1447640504074637312,1447640504074637312,,0,1,1,0,1,1,3,0.444444,0.5,0,18,0,0.000308
859185978434625536,859185978434625536,,0,1,1,0,1,1,1,1,1,0,250,0,0.000003
1421812009209847808,1421812009209847808,,0,1,1,0,1,1,3,0.444444,0.5,0,18,0,0.000308
1202566145703895040,1202566145703895040,,0,0,0,0,0,0,0,0,0,0,439,0,0
1299680278449926144,1299680278449926144,,0,1,1,0,1,1,1,1,1,0,37,0,0.003445
987411073950240768,987411073950240768,,0,1,1,0,1,1,2,0.666667,0.75,0,21,0,0.000949
3457705635,3457705635,,1,0,1,1,0,1,0,0,0,0,18,0,0
132665876,132665876,,0,1,1,0,1,1,3,0.449275,0.473118,0,28,0,0.000035
468439576,468439576,,0,0,0,0,0,0,0,0,0,0,440,0,0
1857326258,1857326258,,0,1,1,0,1,1,1,1,1,0,434,0,0
899192571314016256,899192571314016256,,0,1,1,0,1,1,1,1,1,0,14,0,0.000017
986268867839385600,986268867839385600,,0,1,1,0,1,1,3,0.449275,0.473118,0,28,0,0.000035
1156225273928527872,1156225273928527872,,0,3,3,0,3,3,4,0.492063,0.52957,0,25,0,0.003091
321463844,321463844,,0,1,1,0,1,1,1,1,1,0,28,0,0
307609355,307609355,,5,0,5,5,0,5,0,0,0,0,28,0,0
1053258748230332416,1053258748230332416,,0,1,1,0,1,1,1,1,1,0,14,0,0.000017
1012290634663776256,1012290634663776256,,1,0,1,2,0,2,0,0,0,0,441,0,0
1164336541,1164336541,,0,1,1,0,1,1,1,1,1,0,442,0,0
326854012,326854012,,1,0,1,1,0,1,0,0,0,0,442,0,0
2303850745,2303850745,,2,0,2,3,0,3,0,0,0,0,28,0,0
396103010,396103010,,1,0,1,2,0,2,0,0,0,0,28,0,0
8032202,8032202,,1,0,1,1,0,1,0,0,0,0,28,0,0
421347689,421347689,,1,0,1,1,0,1,0,0,0,0,28,0,0
3045127324,3045127324,,1,1,2,1,1,2,1,1,1,0.000001,28,0,0.00005
1053044102453968896,1053044102453968896,,1,1,2,1,1,2,2,0.666667,0.75,0.000001,28,0,0.00002
1032532981,1032532981,,1,0,1,1,0,1,0,0,0,0,28,0,0
905187705826541568,905187705826541568,,1,3,4,1,3,4,1,1,1,0.000007,28,0,0.000002
1174975232,1174975232,,1,0,1,1,0,1,0,0,0,0,28,0,0
244439360,244439360,,1,0,1,1,0,1,0,0,0,0,28,0,0
232972471,232972471,,1,1,2,3,1,4,1,1,1,0.000008,28,0,0
167566334,167566334,,1,0,1,1,0,1,0,0,0,0,28,0,0
707535275640156160,707535275640156160,,1,0,1,1,0,1,0,0,0,0,28,0,0
357998864,357998864,,1,3,4,1,3,4,1,1,1,0.00001,33,0,0.000031
112807659,112807659,,1,0,1,1,0,1,0,0,0,0,28,0,0
1093923303218130944,1093923303218130944,,1,0,1,1,0,1,0,0,0,0,28,0,0
477543705,477543705,,1,0,1,1,0,1,0,0,0,0,28,0,0
380199752,380199752,,1,0,1,1,0,1,0,0,0,0,28,0,0
926040548,926040548,,1,1,2,1,1,2,2,0.666667,0.75,0.000001,14,0.000001,0.017924
566772201,566772201,,1,2,3,1,2,3,2,0.75,0.833333,0.000001,14,0.000001,0.021369
1407948418836803584,1407948418836803584,,1,0,1,1,0,1,0,0,0,0,14,0.000001,0
964625554262691840,964625554262691840,,1,0,1,1,0,1,0,0,0,0,14,0.000001,0
25141258,25141258,,1,1,2,1,1,2,1,1,1,0,14,0.000001,0.003445
951064045586714624,951064045586714624,,1,0,1,1,0,1,0,0,0,0,14,0.000001,0
537416362,537416362,,1,0,1,1,0,1,0,0,0,0,14,0.000001,0
574185238,574185238,,1,0,1,1,0,1,0,0,0,0,14,0.000001,0
456595925,456595925,,1,0,1,1,0,1,0,0,0,0,14,0.000001,0
408084708,408084708,,1,0,1,1,0,1,0,0,0,0,14,0.000001,0
2759245990,2759245990,,1,0,1,1,0,1,0,0,0,0,14,0.000001,0
83906632,83906632,,1,0,1,1,0,1,0,0,0,0,14,0.000001,0
3565140796,3565140796,,1,0,1,1,0,1,0,0,0,0,14,0.000001,0
1239614768358531072,1239614768358531072,,1,0,1,1,0,1,0,0,0,0,14,0.000001,0
2791785084,2791785084,,1,0,1,1,0,1,0,0,0,0,14,0.000001,0
3131549915,3131549915,,1,0,1,1,0,1,0,0,0,0,14,0.000001,0
1397894191460630528,1397894191460630528,,1,0,1,1,0,1,0,0,0,0,14,0.000001,0
985189174365048832,985189174365048832,,1,0,1,1,0,1,0,0,0,0,14,0.000001,0
428516674,428516674,,0,0,0,0,0,0,0,0,0,0,443,0,0
1223580618732294144,1223580618732294144,,0,0,0,0,0,0,0,0,0,0,444,0,0
3155822716,3155822716,,0,1,1,0,1,1,1,1,1,0,37,0,0.003445
563991668,563991668,,0,0,0,0,0,0,0,0,0,0,445,0,0
753969201384136704,753969201384136704,,0,1,1,0,1,1,2,0.666667,0.75,0,13,0,0.017924
488587270,488587270,,0,0,0,0,0,0,0,0,0,0,446,0,0
4925616683,4925616683,,0,1,1,0,1,1,2,0.666667,0.75,0,28,0,0.00002
242954953,242954953,,0,1,1,0,1,1,2,0.666667,0.75,0,13,0,0.017924
303783071,303783071,,0,0,0,0,0,0,0,0,0,0,447,0,0
1322489722485297152,1322489722485297152,,0,1,1,0,1,1,3,0.478261,0.515152,0,28,0,0
283107590,283107590,,0,1,1,0,1,1,2,0.666667,0.75,0,13,0,0.017924
1033421114419097600,1033421114419097600,,0,3,3,0,3,3,2,0.8,0.875,0,21,0,0.019739
3391775794,3391775794,,0,1,1,0,1,1,2,0.666667,0.75,0,28,0,0.00002
477757835,477757835,,1,0,1,1,0,1,0,0,0,0,28,0,0
1249190218432987136,1249190218432987136,,0,1,1,0,1,1,1,1,1,0,21,0,0.000866
1834306566,1834306566,,0,1,1,0,1,1,1,1,1,0,18,0,0.000018
1035239332691562496,1035239332691562496,,0,1,1,0,1,1,2,0.666667,0.75,0,21,0,0.000949
230224500,230224500,,0,1,1,0,1,1,2,0.666667,0.75,0,21,0,0.000949
1169470826732822528,1169470826732822528,,0,0,0,0,0,0,0,0,0,0,448,0,0
1355800060672561152,1355800060672561152,,0,1,1,0,1,1,1,1,1,0,449,0,0
69959408,69959408,,1,0,1,1,0,1,0,0,0,0,449,0,0
1323023005304430592,1323023005304430592,,0,1,1,0,1,1,2,0.666667,0.75,0,28,0,0.00002
907209567406358528,907209567406358528,,0,1,1,0,1,1,1,1,1,0,37,0,0.003445
1278633506,1278633506,,0,1,1,0,1,1,1,1,1,0,37,0,0.003445
1433531824261656576,1433531824261656576,,0,1,1,0,1,1,1,1,1,0,37,0,0.003445
791671886690353152,791671886690353152,,0,1,1,0,1,1,1,1,1,0,21,0,0.000866
792003323998109696,792003323998109696,,0,2,2,0,2,2,1,1,1,0,5,0,0.003506
446355008,446355008,,0,1,1,0,1,1,1,1,1,0,21,0,0.000866
1469982290,1469982290,,0,1,1,0,1,1,1,1,1,0,21,0,0.000866
1008459450661949440,1008459450661949440,,0,1,1,0,1,1,2,0.666667,0.75,0,21,0,0.000949
1298300883147599872,1298300883147599872,,1,0,1,1,0,1,0,0,0,0,28,0,0
1145649990922047488,1145649990922047488,,1,0,1,1,0,1,0,0,0,0,28,0,0
1315897868,1315897868,,1,0,1,1,0,1,0,0,0,0,28,0,0
1234493292575936512,1234493292575936512,,1,1,2,1,1,2,1,1,1,0.000002,28,0,0.000001
3309021569,3309021569,,1,0,1,1,0,1,0,0,0,0,28,0,0
477669251,477669251,,1,0,1,1,0,1,0,0,0,0,28,0,0
821245141184823296,821245141184823296,,1,0,1,1,0,1,0,0,0,0,28,0,0
1447058714901557248,1447058714901557248,,0,1,1,0,1,1,2,0.666667,0.75,0,14,0,0
2870829545,2870829545,,0,1,1,0,1,1,2,0.666667,0.75,0,21,0,0.000949
1146433044737417216,1146433044737417216,,0,1,1,0,1,1,1,1,1,0,37,0,0.003445
2288643866,2288643866,,0,1,1,0,1,1,2,0.666667,0.75,0,21,0,0.000949
1066079114103271424,1066079114103271424,,0,1,1,0,1,1,1,1,1,0,15,0,0.001469
188043254,188043254,,0,1,1,0,1,1,1,1,1,0,21,0,0.000866
416346211,416346211,,0,1,1,0,1,1,1,1,1,0,21,0,0.000866
1279134201854509056,1279134201854509056,,0,1,1,0,1,1,2,0.666667,0.75,0,13,0,0.017924
1389670393,1389670393,,0,1,1,0,1,1,2,0.666667,0.75,0,21,0,0.000949
1382686803174563840,1382686803174563840,,0,1,1,0,1,1,1,1,1,0,21,0,0.000866
1402578117877800960,1402578117877800960,,0,1,1,0,1,1,2,0.666667,0.75,0,21,0,0.000949
1071164555907252224,1071164555907252224,,0,1,1,0,1,1,1,1,1,0,18,0,0.000018
442225392,442225392,,0,1,1,0,1,1,2,0.666667,0.75,0,13,0,0
56341776,56341776,,0,0,0,0,0,0,0,0,0,0,450,0,0
428259355,428259355,,0,1,1,0,1,1,2,0.666667,0.75,0,33,0,0
2925056038,2925056038,,0,2,2,0,2,2,1,1,1,0,21,0,0.001814
4869405783,4869405783,,0,1,1,0,1,1,1,1,1,0,37,0,0.003445
485524193,485524193,,0,1,1,0,1,1,1,1,1,0,28,0,0.000002
1096126365215178752,1096126365215178752,,0,1,1,0,1,1,1,1,1,0,37,0,0.003445
4482272722,4482272722,,0,1,1,0,1,1,2,0.666667,0.75,0,28,0,0.00002
472817547,472817547,,0,1,1,0,1,1,2,0.666667,0.75,0,13,0,0.017924
1317568957428191232,1317568957428191232,,0,1,1,0,1,1,1,1,1,0,28,0,0.000001
1079175701746671616,1079175701746671616,,0,1,1,0,1,1,2,0.666667,0.75,0,13,0,0.017924
416476798,416476798,,2,0,2,4,0,4,0,0,0,0,206,0,0
3052503691,3052503691,,1,0,1,2,0,2,0,0,0,0,206,0,0
4480118843,4480118843,,0,1,1,0,1,1,1,1,1,0,37,0,0.003445
437513705,437513705,,0,2,2,0,2,2,1,1,1,0,25,0,0.004065
469657784,469657784,,0,1,1,0,1,1,1,1,1,0,451,0,0
1448183250611052544,1448183250611052544,,3,0,3,3,0,3,0,0,0,0,451,0,0
4866412145,4866412145,,0,1,1,0,1,1,1,1,1,0,451,0,0
1219650170,1219650170,,0,1,1,0,1,1,2,0.666667,0.75,0,13,0,0.017924
736231985186779136,736231985186779136,,0,1,1,0,1,1,2,0.666667,0.75,0,21,0,0.000949
4061316509,4061316509,,0,1,1,0,1,1,2,0.666667,0.75,0,21,0,0.000949
946403289658281984,946403289658281984,,0,1,1,0,1,1,2,0.666667,0.75,0,21,0,0.000949
131126639,131126639,,0,2,2,0,2,2,2,0.75,0.833333,0,21,0,0.004393
826540340349919232,826540340349919232,,0,1,1,0,1,1,2,0.666667,0.75,0,21,0,0.000949
1291810156272128000,1291810156272128000,,0,0,0,0,0,0,0,0,0,0,452,0,0
987419874472415232,987419874472415232,,0,1,1,0,1,1,1,1,1,0,33,0,0.00003
1468289749,1468289749,,0,0,0,0,0,0,0,0,0,0,453,0,0
1296134026282115072,1296134026282115072,,0,2,2,0,2,2,1,1,1,0,21,0,0.001814
1430788326727065600,1430788326727065600,,1,0,1,1,0,1,0,0,0,0,15,0,0
390208721,390208721,,1,0,1,1,0,1,0,0,0,0,15,0,0
744938060824125440,744938060824125440,,0,1,1,0,1,1,1,1,1,0,37,0,0.003445
1232262081027739648,1232262081027739648,,0,2,2,0,3,3,1,1,1,0,18,0,0
3007937662,3007937662,,0,1,1,0,1,1,1,1,1,0,28,0,0.00005
278743750,278743750,,0,1,1,0,1,1,2,0.666667,0.75,0,21,0,0.000949
3138188655,3138188655,,0,1,1,0,1,1,2,0.666667,0.75,0,21,0,0.000949
1253709096651497472,1253709096651497472,,0,2,2,0,2,2,2,0.666667,0.75,0,21,0,0.018873
473035394,473035394,,0,1,1,0,1,1,1,1,1,0,33,0,0.00003
1302251133969326080,1302251133969326080,,0,1,1,0,1,1,2,0.666667,0.75,0,21,0,0.000949
1223662912713232384,1223662912713232384,,0,1,1,0,1,1,2,0.666667,0.75,0,21,0,0.000949
909156725659402240,909156725659402240,,0,1,1,0,1,1,1,1,1,0,37,0,0.003445
1044144480964800512,1044144480964800512,,0,2,2,0,2,2,1,1,1,0,37,0,0.003549
1051906012104540160,1051906012104540160,,0,3,3,0,4,4,2,0.8,0.875,0,21,0,0.004397
428041816,428041816,,1,0,1,2,0,2,0,0,0,0,21,0.000128,0
1343167793819213824,1343167793819213824,,0,1,1,0,1,1,1,1,1,0,37,0,0.003445
991380081590317056,991380081590317056,,0,1,1,0,1,1,1,1,1,0,18,0,0.00002
889147867251847168,889147867251847168,,0,1,1,0,1,1,1,1,1,0,37,0,0.003445
770258947710263296,770258947710263296,,0,1,1,0,1,1,2,0.666667,0.75,0,13,0,0.017924
52207353,52207353,,0,1,1,0,1,1,1,1,1,0,454,0,0
1244636008102211584,1244636008102211584,,2,0,2,2,0,2,0,0,0,0,454,0,0
1182206185723875328,1182206185723875328,,0,1,1,0,1,1,1,1,1,0,37,0,0.003445
733383127381487616,733383127381487616,,0,1,1,0,1,1,2,0.666667,0.75,0,21,0,0.000949
412501254,412501254,,0,1,1,0,1,1,1,1,1,0,37,0,0.003445
1061223105207640064,1061223105207640064,,0,1,1,0,1,1,1,1,1,0,454,0,0
1114648990816120832,1114648990816120832,,0,1,1,0,1,1,4,0.435897,0.47549,0,28,0,0.000004
1087422900410482688,1087422900410482688,,0,0,0,0,0,0,0,0,0,0,455,0,0
163818204,163818204,,0,1,1,0,1,1,1,1,1,0,456,0,0
804354408,804354408,,4,0,4,4,0,4,0,0,0,0,456,0,0
1033025400555954176,1033025400555954176,,0,1,1,0,1,1,2,0.666667,0.75,0,21,0,0.000949
998956710,998956710,,0,1,1,0,1,1,2,0.666667,0.75,0,21,0,0.000949
1256877102504325120,1256877102504325120,,0,0,0,0,0,0,0,0,0,0,457,0,0
412556755,412556755,,0,0,0,0,0,0,0,0,0,0,458,0,0
1433103620413788160,1433103620413788160,,0,1,1,0,1,1,2,0.666667,0.75,0,21,0,0.000949
1424322463735943168,1424322463735943168,,0,1,1,0,1,1,2,0.666667,0.75,0,13,0,0.017924
1171160787127361536,1171160787127361536,,0,1,1,0,1,1,1,1,1,0,15,0,0.001469
1430411453748613120,1430411453748613120,,0,1,1,0,1,1,2,0.666667,0.75,0,21,0,0.000949
3401651157,3401651157,,0,1,1,0,1,1,1,1,1,0,456,0,0
226064588,226064588,,0,1,1,0,1,1,1,1,1,0,18,0,0
881806877146968064,881806877146968064,,0,1,1,0,1,1,2,0.666667,0.75,0,13,0,0.017924
741203624420888576,741203624420888576,,0,0,0,0,0,0,0,0,0,0,459,0,0
1254440240,1254440240,,0,0,0,0,0,0,0,0,0,0,460,0,0
1446079513776037888,1446079513776037888,,0,1,1,0,1,1,2,0.666667,0.75,0,13,0,0.017924
2588366118,2588366118,,0,1,1,0,1,1,2,0.666667,0.75,0,13,0,0.00002
739708146655100928,739708146655100928,,0,1,1,0,1,1,1,1,1,0,37,0,0.003445
405145648,405145648,,0,1,1,0,1,1,1,1,1,0,28,0,0
1367577093215780864,1367577093215780864,,0,1,1,0,1,1,1,1,1,0,28,0,0
972904650256146432,972904650256146432,,0,2,2,0,2,2,2,0.75,0.833333,0,57,0,0.00002
3211814717,3211814717,,0,1,1,0,1,1,1,1,1,0,33,0,0.00003
423727893,423727893,,0,1,1,0,1,1,1,1,1,0,57,0,0
1325164382888755200,1325164382888755200,,0,1,1,0,1,1,1,1,1,0,57,0,0
1045207930411323392,1045207930411323392,,0,0,0,0,0,0,0,0,0,0,461,0,0
1261605332440285184,1261605332440285184,,0,0,0,0,0,0,0,0,0,0,462,0,0
1197201381041594368,1197201381041594368,,0,1,1,0,1,1,1,1,1,0,37,0,0.003445
390266324,390266324,,0,1,1,0,1,1,1,1,1,0,37,0,0.003445
4323818897,4323818897,,0,0,0,0,0,0,0,0,0,0,463,0,0
3182081069,3182081069,,0,1,1,0,1,1,2,0.666667,0.75,0,13,0,0.017924
48052306,48052306,,0,1,1,0,1,1,1,1,1,0,28,0,0
1374705932496744448,1374705932496744448,,0,0,0,0,0,0,0,0,0,0,464,0,0
1430145720619880448,1430145720619880448,,0,1,1,0,1,1,3,0.428571,0.5,0,21,0,0.000033
1389590952281616384,1389590952281616384,,0,1,1,0,1,1,4,0.37931,0.431818,0,9,0,0.000021
507152939,507152939,,0,1,1,0,1,1,1,1,1,0,37,0,0.003445
1420454611949924352,1420454611949924352,,0,1,1,0,1,1,4,0.37931,0.431818,0,9,0,0.000021
2396856942,2396856942,,0,1,1,0,1,1,2,0.666667,0.75,0,13,0,0.017924
312027725,312027725,,0,1,1,0,1,1,1,1,1,0,15,0,0.001469
819917515,819917515,,0,2,2,0,2,2,1,1,1,0,14,0,0.004958
200165465,200165465,,0,1,1,0,1,1,2,0.666667,0.75,0,13,0,0.017924
128311427,128311427,,0,1,1,0,1,1,1,1,1,0,37,0,0.003445
144087344,144087344,,0,1,1,0,1,1,2,0.666667,0.75,0,13,0,0.017924
1535934018,1535934018,,0,1,1,0,1,1,1,1,1,0,37,0,0.003445
1254757129,1254757129,,0,1,1,0,1,1,1,1,1,0,37,0,0.003445
4202067873,4202067873,,0,2,2,0,2,2,1,1,1,0,15,0,0.001156
1222740044,1222740044,,1,0,1,2,0,2,0,0,0,0,18,0.000524,0
412168233,412168233,,0,1,1,0,1,1,2,0.666667,0.75,0,28,0,0.00002
751532546798841856,751532546798841856,,0,1,1,0,1,1,1,1,1,0,28,0,0
1007701413210845184,1007701413210845184,,0,1,1,0,1,1,1,1,1,0,21,0,0.000866
1200977984,1200977984,,0,0,0,0,0,0,0,0,0,0,465,0,0
498611410,498611410,,0,1,1,0,1,1,1,1,1,0,37,0,0.003445
1953430410,1953430410,,0,1,1,0,1,1,2,0.666667,0.75,0,28,0,0.00002
1199407342854561792,1199407342854561792,,0,1,1,0,1,1,1,1,1,0,37,0,0.003445
1172571984967942144,1172571984967942144,,0,2,2,0,2,2,2,0.75,0.833333,0,21,0,0.003556
2278659026,2278659026,,0,1,1,0,1,1,1,1,1,0,14,0,0.001513
599039512,599039512,,0,3,3,0,3,3,2,0.8,0.875,0,14,0,0.022882
2870835862,2870835862,,0,1,1,0,1,1,1,1,1,0,37,0,0.003445
1369292299830779904,1369292299830779904,,0,1,1,0,1,1,1,1,1,0,28,0,0
124883542,124883542,,0,1,1,0,1,1,1,1,1,0,37,0,0.003445
1323872971082076160,1323872971082076160,,0,1,1,0,1,1,1,1,1,0,37,0,0.003445
18588567,18588567,,0,0,0,0,0,0,0,0,0,0,466,0,0
153519870,153519870,,0,1,1,0,1,1,1,1,1,0,57,0,0.000035
3004111521,3004111521,,0,1,1,0,1,1,1,1,1,0,37,0,0.003445
1162664172511014912,1162664172511014912,,0,2,2,0,2,2,1,1,1,0,21,0,0.000022
860015294,860015294,,1,0,1,1,0,1,0,0,0,0,21,0.000001,0
115515270,115515270,,0,1,1,0,1,1,2,0.666667,0.75,0,13,0,0.017924
334342942,334342942,,0,1,1,0,1,1,1,1,1,0,37,0,0.003445
1335595200010448896,1335595200010448896,,0,1,1,0,1,1,1,1,1,0,467,0,0
2719018261,2719018261,,1,0,1,1,0,1,0,0,0,0,467,0,0
2158606443,2158606443,,0,0,0,0,0,0,0,0,0,0,468,0,0
880502911,880502911,,0,0,0,0,0,0,0,0,0,0,469,0,0
946380483742633984,946380483742633984,,0,1,1,0,1,1,1,1,1,0,37,0,0.000105
1401427332657713152,1401427332657713152,,0,1,1,0,1,1,2,0.666667,0.75,0,28,0,0.00002
748145329132961792,748145329132961792,,0,1,1,0,1,1,2,0.666667,0.75,0,13,0,0.017924
1001570784169594880,1001570784169594880,,0,2,2,0,2,2,2,0.75,0.833333,0,13,0,0.017991
406373933,406373933,,0,1,1,0,1,1,1,1,1,0,37,0,0.003445
569950296,569950296,,0,1,1,0,1,1,2,0.666667,0.75,0,28,0,0.00002
1385265387546238976,1385265387546238976,,0,2,2,0,2,2,1,1,1,0,25,0,0.004065
576267509,576267509,,0,1,1,0,1,1,1,1,1,0,33,0,0.00003
161044379,161044379,,0,1,1,0,1,1,2,0.666667,0.75,0,28,0,0.00002
1144913517365145600,1144913517365145600,,0,1,1,0,1,1,2,0.666667,0.75,0,13,0,0.017924
236997869,236997869,,0,0,0,0,0,0,0,0,0,0,470,0,0
1422247668567486464,1422247668567486464,,0,0,0,0,0,0,0,0,0,0,471,0,0
1243705190,1243705190,,0,1,1,0,1,1,1,1,1,0,472,0,0
3435440825,3435440825,,1,0,1,1,0,1,0,0,0,0,472,0,0
1001498423194017792,1001498423194017792,,0,1,1,0,1,1,1,1,1,0,21,0,0.000866
1314452513249275904,1314452513249275904,,0,1,1,0,1,1,2,0.666667,0.75,0,13,0,0.017924
1050412943622529024,1050412943622529024,,0,0,0,0,0,0,0,0,0,0,473,0,0
935205362885627904,935205362885627904,,1,0,1,2,0,2,0,0,0,0,14,0.000101,0
1156830576592203776,1156830576592203776,,0,1,1,0,1,1,1,1,1,0,15,0,0.001469
1347215707587670016,1347215707587670016,,0,0,0,0,0,0,0,0,0,0,474,0,0
3102617019,3102617019,,0,2,2,0,2,2,1,1,1,0,21,0,0.000869
881014213,881014213,,2,0,2,2,0,2,0,0,0,0,21,0.000126,0
1146328255844245504,1146328255844245504,,0,3,3,0,4,4,2,0.8,0.875,0,17,0,0.017956
720792310,720792310,,1,0,1,2,0,2,0,0,0,0,17,0.000525,0
1231509474596265984,1231509474596265984,,0,1,1,0,1,1,1,1,1,0,475,0,0
1393680387012976640,1393680387012976640,,1,0,1,1,0,1,0,0,0,0,475,0,0
508693,508693,,0,1,1,0,1,1,1,1,1,0,476,0,0
249951516,249951516,,1,0,1,1,0,1,0,0,0,0,476,0,0
1683235070,1683235070,,0,1,1,0,1,1,1,1,1,0,14,0,0.001513
980074483,980074483,,0,1,1,0,1,1,1,1,1,0,37,0,0.003445
751414388,751414388,,1,0,1,2,0,2,0,0,0,0,15,0.000043,0
463227847,463227847,,0,1,1,0,1,1,1,1,1,0,37,0,0.003445
947539589979394048,947539589979394048,,0,1,1,0,1,1,1,1,1,0,28,0,0.000001
2152957786,2152957786,,0,1,1,0,1,1,1,1,1,0,37,0,0.003445
1010757682293366784,1010757682293366784,,0,1,1,0,1,1,1,1,1,0,25,0,0.00062
501813967,501813967,,1,0,1,2,0,2,0,0,0,0,25,0,0
2896406495,2896406495,,0,1,1,0,1,1,2,0.666667,0.75,0,13,0,0.00002
1255923563388952576,1255923563388952576,,0,1,1,0,1,1,1,1,1,0,477,0,0
428931682,428931682,,2,0,2,2,0,2,0,0,0,0,477,0,0
2733209785,2733209785,,0,0,0,0,0,0,0,0,0,0,478,0,0
3040616668,3040616668,,0,1,1,0,1,1,1,1,1,0,15,0,0.001469
2333704591,2333704591,,0,0,0,0,0,0,0,0,0,0,479,0,0
939484063,939484063,,0,2,2,0,2,2,1,1,1,0,21,0,0.003448
955578366,955578366,,0,1,1,0,1,1,1,1,1,0,21,0,0.000866
1396212248457236480,1396212248457236480,,0,1,1,0,1,1,1,1,1,0,14,0,0.001513
271838807,271838807,,0,1,1,0,1,1,2,0.666667,0.75,0,13,0,0.017924
1147147972842524672,1147147972842524672,,0,0,0,0,0,0,0,0,0,0,480,0,0
912365491443916800,912365491443916800,,0,1,1,0,1,1,1,1,1,0,5,0,0.000243
105828688,105828688,,0,0,0,0,0,0,0,0,0,0,481,0,0
551650362,551650362,,0,1,1,0,1,1,1,1,1,0,33,0,0.00003
2763305468,2763305468,,0,0,0,0,0,0,0,0,0,0,482,0,0
1429429903200559104,1429429903200559104,,0,1,1,0,1,1,2,0.666667,0.75,0,13,0,0.017924
2541809095,2541809095,,0,1,1,0,1,1,1,1,1,0,37,0,0.003445
931126637508382720,931126637508382720,,0,0,0,0,0,0,0,0,0,0,483,0,0
58205886,58205886,,0,1,1,0,1,1,1,1,1,0,28,0,0
1158280734,1158280734,,6,0,6,6,0,6,0,0,0,0,28,0.000002,0
1030403730,1030403730,,0,0,0,0,0,0,0,0,0,0,484,0,0
1433772602284257280,1433772602284257280,,0,1,1,0,1,1,2,0.666667,0.75,0,13,0,0.017924
1299738680,1299738680,,0,1,1,0,1,1,1,1,1,0,18,0,0
844546704603074560,844546704603074560,,0,0,0,0,0,0,0,0,0,0,485,0,0
337282313,337282313,,0,1,1,0,1,1,1,1,1,0,57,0,0.000035
2505036552,2505036552,,0,0,0,0,0,0,0,0,0,0,486,0,0
4196804241,4196804241,,0,1,1,0,1,1,1,1,1,0,14,0,0.001513
417735272,417735272,,0,1,1,0,1,1,1,1,1,0,37,0,0.003445
288858583,288858583,,0,1,1,0,1,1,1,1,1,0,28,0,0.00005
1002172878,1002172878,,0,1,1,0,1,1,1,1,1,0,28,0,0.000002
1390039296132927488,1390039296132927488,,0,1,1,0,1,1,1,1,1,0,15,0,0.00029
45392303,45392303,,0,1,1,0,1,1,1,1,1,0,487,0,0
1383472028317982720,1383472028317982720,,1,0,1,1,0,1,0,0,0,0,487,0,0
714226829071151104,714226829071151104,,0,1,1,0,1,1,1,1,1,0,37,0,0.003445
1322549988,1322549988,,0,0,0,0,0,0,0,0,0,0,488,0,0
1164594086722068480,1164594086722068480,,0,1,1,0,1,1,1,1,1,0,15,0,0.00039
1524554196,1524554196,,0,1,1,0,1,1,1,1,1,0,14,0,0.001513
15930944,15930944,,1,0,1,1,0,1,0,0,0,0,15,0,0
821281247842410496,821281247842410496,,0,1,1,0,1,1,2,0.666667,0.75,0,13,0,0.017924
414722911,414722911,,1,0,1,1,0,1,0,0,0,0,57,0,0
2462209320,2462209320,,0,1,1,0,1,1,2,0.666667,0.75,0,13,0,0.017924
752943641585418240,752943641585418240,,0,1,1,0,1,1,1,1,1,0,28,0,0
592269529,592269529,,1,0,1,1,0,1,0,0,0,0,13,0,0
1058145858,1058145858,,0,1,1,0,1,1,1,1,1,0,37,0,0.003445
429231339,429231339,,0,0,0,0,0,0,0,0,0,0,489,0,0
257511513,257511513,,0,1,1,0,1,1,2,0.666667,0.75,0,28,0,0.00002
1421451388488462336,1421451388488462336,,0,1,1,0,1,1,2,0.666667,0.75,0,33,0,0
1055356981,1055356981,,0,1,1,0,1,1,2,0.666667,0.75,0,28,0,0.00002
735183717518299136,735183717518299136,,0,2,2,0,2,2,1,1,1,0,13,0,0.000045
2157554042,2157554042,,0,1,1,0,1,1,1,1,1,0,28,0,0
472040005,472040005,,0,0,0,0,0,0,0,0,0,0,490,0,0
1095418857689358336,1095418857689358336,,0,0,0,0,0,0,0,0,0,0,491,0,0
1372827705142611968,1372827705142611968,,0,1,1,0,1,1,1,1,1,0,492,0,0
68349483,68349483,,1,0,1,1,0,1,0,0,0,0,492,0,0
3385040056,3385040056,,0,1,1,0,1,1,1,1,1,0,493,0,0
874933332903174144,874933332903174144,,1,0,1,1,0,1,0,0,0,0,493,0,0
1001997313,1001997313,,0,1,1,0,1,1,1,1,1,0,37,0,0.003445
208204460,208204460,,0,2,2,0,3,3,3,0.529412,0.592593,0,9,0,0.000001
987756923129876480,987756923129876480,,1,0,1,1,0,1,0,0,0,0,9,0,0
383116512,383116512,,5,0,5,5,0,5,0,0,0,0,33,0.000001,0
1894270790,1894270790,,0,1,1,0,1,1,2,0.666667,0.75,0,13,0,0.017924
1325284806536671232,1325284806536671232,,0,1,1,0,1,1,3,0.5,0.611111,0,15,0,0.000019
1595843437,1595843437,,0,1,1,0,1,1,1,1,1,0,21,0,0.000866
1070045085784518656,1070045085784518656,,0,1,1,0,1,1,1,1,1,0,28,0,0
1562770316,1562770316,,0,1,1,0,1,1,2,0.666667,0.75,0,13,0,0.017924
3299563144,3299563144,,0,1,1,0,1,1,1,1,1,0,494,0,0
248176574,248176574,,1,0,1,1,0,1,0,0,0,0,494,0,0
1436221163819110400,1436221163819110400,,0,1,1,0,1,1,2,0.666667,0.75,0,28,0,0.00002
232572012,232572012,,0,1,1,0,1,1,2,0.666667,0.75,0,13,0,0.017924
429628157,429628157,,0,1,1,0,1,1,1,1,1,0,495,0,0
710238049213550592,710238049213550592,,1,0,1,1,0,1,0,0,0,0,495,0,0
2464793882,2464793882,,0,1,1,0,1,1,1,1,1,0,37,0,0.003445
3310167993,3310167993,,0,1,1,0,1,1,1,1,1,0,37,0,0.003445
193683700,193683700,,0,0,0,0,0,0,0,0,0,0,496,0,0
419760997,419760997,,0,2,2,0,2,2,4,0.45,0.50463,0,28,0,0.000004
517644767,517644767,,0,1,1,0,1,1,1,1,1,0,21,0,0.000866
3342960040,3342960040,,0,1,1,0,1,1,2,0.666667,0.75,0,13,0,0.017924
3058264727,3058264727,,0,1,1,0,1,1,1,1,1,0,21,0,0.000866
723993776008605696,723993776008605696,,0,1,1,0,1,1,2,0.666667,0.75,0,13,0,0.017924
404961989,404961989,,0,1,1,0,1,1,2,0.666667,0.75,0,28,0,0.00002
1702809366,1702809366,,0,1,1,0,2,2,3,0.461538,0.527778,0,110,0,0.000024
1163643518,1163643518,,0,1,1,0,1,1,1,1,1,0,37,0,0.003445
390642582,390642582,,0,1,1,0,1,1,1,1,1,0,28,0,0.00005
84193474,84193474,,0,1,1,0,1,1,1,1,1,0,37,0,0.003445
476224626,476224626,,0,1,1,0,1,1,3,0.5,0.611111,0,28,0,0
1858471,1858471,,0,0,0,0,0,0,0,0,0,0,497,0,0
1389253472571297792,1389253472571297792,,0,1,1,0,1,1,3,0.5,0.583333,0,206,0,0.000018
480612566,480612566,,0,0,0,0,0,0,0,0,0,0,498,0,0
1421851278125187072,1421851278125187072,,0,1,1,0,1,1,1,1,1,0,37,0,0.003445
1965068672,1965068672,,0,0,0,0,0,0,0,0,0,0,499,0,0
1012387924745359360,1012387924745359360,,0,1,1,0,1,1,1,1,1,0,451,0,0
917084680435982336,917084680435982336,,0,1,1,0,1,1,1,1,1,0,28,0,0
479458968,479458968,,0,0,0,0,0,0,0,0,0,0,500,0,0
1387283916,1387283916,,0,1,1,0,1,1,1,1,1,0,37,0,0.003445
1006873192374382592,1006873192374382592,,0,1,1,0,1,1,2,0.666667,0.75,0,13,0,0.017924
1433773018547953664,1433773018547953664,,0,1,1,0,1,1,2,0.666667,0.75,0,13,0,0.017924
1435279781579395072,1435279781579395072,,0,1,1,0,1,1,1,1,1,0,5,0,0.000062
816809660162379776,816809660162379776,,0,1,1,0,1,1,2,0.666667,0.75,0,15,0,0.000074
1334549815276003328,1334549815276003328,,0,1,1,0,1,1,2,0.666667,0.75,0,13,0,0.017924
1347014251307790336,1347014251307790336,,0,1,1,0,1,1,1,1,1,0,28,0,0.000001
1238820601491533824,1238820601491533824,,0,1,1,0,1,1,1,1,1,0,28,0,0
4495223841,4495223841,,0,0,0,0,0,0,0,0,0,0,501,0,0
974579030,974579030,,0,1,1,0,1,1,2,0.666667,0.75,0,13,0,0.017924
3128007835,3128007835,,0,1,1,0,1,1,1,1,1,0,15,0,0.00039
304638309,304638309,,0,1,1,0,1,1,1,1,1,0,18,0,0
1092371488483827712,1092371488483827712,,0,1,1,0,1,1,1,1,1,0,14,0,0.001513
236335841,236335841,,0,2,2,0,2,2,1,1,1,0,28,0,0.000002
15101541,15101541,,0,1,1,0,1,1,1,1,1,0,37,0,0.003445
1361708719751454720,1361708719751454720,,0,1,1,0,1,1,2,0.666667,0.75,0,13,0,0.017924
268894777,268894777,,0,1,1,0,1,1,2,0.666667,0.75,0,13,0,0.017924
10405152,10405152,,0,1,1,0,1,1,1,1,1,0,28,0,0.000002
3038933044,3038933044,,0,3,3,0,3,3,2,0.8,0.875,0,21,0,0.022235
3070700175,3070700175,,0,1,1,0,1,1,1,1,1,0,21,0,0.000866
1302258518221828096,1302258518221828096,,0,1,1,0,1,1,1,1,1,0,502,0,0
1144950428087586816,1144950428087586816,,1,0,1,1,0,1,0,0,0,0,502,0,0
40767208,40767208,,0,1,1,0,1,1,1,1,1,0,14,0,0
2870351313,2870351313,,0,1,1,0,1,1,1,1,1,0,419,0,0
956555279549779968,956555279549779968,,0,0,0,0,0,0,0,0,0,0,503,0,0
1362134733271007232,1362134733271007232,,1,1,2,1,1,2,1,1,1,0,28,0,0.000001
438258080,438258080,,0,1,1,0,1,1,1,1,1,0,28,0,0
423578119,423578119,,0,0,0,0,0,0,0,0,0,0,504,0,0
2958168039,2958168039,,0,1,1,0,1,1,1,1,1,0,28,0,0
419421043,419421043,,0,0,0,0,0,0,0,0,0,0,505,0,0
495127481,495127481,,0,1,1,0,1,1,1,1,1,0,28,0,0.000002
43496528,43496528,,0,0,0,0,0,0,0,0,0,0,506,0,0
2726112076,2726112076,,0,1,1,0,1,1,1,1,1,0,37,0,0.003445
57877333,57877333,,0,1,1,0,1,1,1,1,1,0,507,0,0
1117398493247754240,1117398493247754240,,1,0,1,1,0,1,0,0,0,0,507,0,0
719107989114892288,719107989114892288,,0,0,0,0,0,0,0,0,0,0,508,0,0
1334136312832684032,1334136312832684032,,0,0,0,0,0,0,0,0,0,0,509,0,0
94347187,94347187,,0,0,0,0,0,0,0,0,0,0,510,0,0
1427675925823504384,1427675925823504384,,0,0,0,0,0,0,0,0,0,0,511,0,0
1095816971185258496,1095816971185258496,,0,1,1,0,1,1,1,1,1,0,15,0,0.001469
20205982,20205982,,0,0,0,0,0,0,0,0,0,0,512,0,0
1284443441179631616,1284443441179631616,,0,0,0,0,0,0,0,0,0,0,513,0,0
472287812,472287812,,0,0,0,0,0,0,0,0,0,0,514,0,0
4252136927,4252136927,,0,1,1,0,1,1,2,0.666667,0.75,0,33,0,0
2629250986,2629250986,,0,1,1,0,1,1,2,0.666667,0.75,0,13,0,0.017924
1404095153095200768,1404095153095200768,,0,1,1,0,1,1,2,0.666667,0.75,0,13,0,0.017924
402834496,402834496,,0,0,0,0,0,0,0,0,0,0,515,0,0
437635996,437635996,,0,1,1,0,1,1,1,1,1,0,57,0,0
83684008,83684008,,0,0,0,0,0,0,0,0,0,0,516,0,0
746108643792257024,746108643792257024,,0,0,0,0,0,0,0,0,0,0,517,0,0
463168228,463168228,,0,1,1,0,2,2,2,0.666667,0.75,0,18,0,0.000001
1101446990,1101446990,,0,0,0,0,0,0,0,0,0,0,518,0,0
70353394,70353394,,0,0,0,0,0,0,0,0,0,0,519,0,0
984398831960907776,984398831960907776,,0,1,1,0,1,1,2,0.666667,0.75,0,33,0,0
1130420497,1130420497,,0,1,1,0,1,1,1,1,1,0,28,0,0
1324264786381647872,1324264786381647872,,0,1,1,0,1,1,2,0.666667,0.75,0,13,0,0.017924
1405122721156108288,1405122721156108288,,0,0,0,0,0,0,0,0,0,0,520,0,0
1540767944,1540767944,,0,1,1,0,1,1,1,1,1,0,37,0,0.003445
1396780739367165952,1396780739367165952,,0,1,1,0,1,1,1,1,1,0,25,0,0.00062
1449279928030187520,1449279928030187520,,0,0,0,0,0,0,0,0,0,0,521,0,0
52091507,52091507,,0,0,0,0,0,0,0,0,0,0,522,0,0
70054648,70054648,,0,1,1,0,1,1,1,1,1,0,523,0,0
156198228,156198228,,2,0,2,2,0,2,0,0,0,0,523,0,0
510595074,510595074,,0,0,0,0,0,0,0,0,0,0,524,0,0
868541922,868541922,,0,0,0,0,0,0,0,0,0,0,525,0,0
1192449294667853824,1192449294667853824,,0,1,1,0,1,1,2,0.666667,0.75,0,13,0,0.017924
1255136037044539392,1255136037044539392,,0,0,0,0,0,0,0,0,0,0,526,0,0
1248365893681283072,1248365893681283072,,0,1,1,0,1,1,1,1,1,0,37,0,0.003445
3170191802,3170191802,,0,1,1,0,1,1,2,0.666667,0.75,0,13,0,0.017924
53043058,53043058,,0,1,1,0,1,1,1,1,1,0,28,0,0.00005
2848388597,2848388597,,0,1,1,0,1,1,1,1,1,0,33,0,0.00003
1372078580,1372078580,,0,1,1,0,1,1,1,1,1,0,28,0,0.00005
762446357776838656,762446357776838656,,0,0,0,0,0,0,0,0,0,0,527,0,0
143079781,143079781,,0,3,3,0,5,5,2,0.8,0.875,0,28,0,0
22038676,22038676,,1,0,1,2,0,2,0,0,0,0,28,0,0
303455815,303455815,,0,1,1,0,1,1,2,0.666667,0.75,0,13,0,0.017924
2328829536,2328829536,,0,1,1,0,1,1,1,1,1,0,37,0,0.003445
941817729648156672,941817729648156672,,0,1,1,0,1,1,2,0.666667,0.75,0,13,0,0.017924
179496198,179496198,,0,1,1,0,1,1,1,1,1,0,15,0,0.001469
484283827,484283827,,0,1,1,0,1,1,1,1,1,0,57,0,0.000035
1429797346678874112,1429797346678874112,,0,0,0,0,0,0,0,0,0,0,528,0,0
532551857,532551857,,0,1,1,0,1,1,1,1,1,0,37,0,0.003445
865640086708211712,865640086708211712,,0,1,1,0,1,1,1,1,1,0,37,0,0.003445
489337776,489337776,,0,1,1,0,1,1,1,1,1,0,14,0,0.001513
959149004851417088,959149004851417088,,0,1,1,0,1,1,2,0.666667,0.75,0,13,0,0.017924
1330939518577504256,1330939518577504256,,0,1,1,0,1,1,2,0.666667,0.75,0,13,0,0.017924
1216148624243118080,1216148624243118080,,0,1,1,0,1,1,1,1,1,0,529,0,0
1039806678672322560,1039806678672322560,,1,0,1,1,0,1,0,0,0,0,529,0,0
829488521454952448,829488521454952448,,0,0,0,0,0,0,0,0,0,0,530,0,0
950051781014360064,950051781014360064,,0,1,1,0,1,1,1,1,1,0,57,0,0.000035
2737028641,2737028641,,0,1,1,0,1,1,1,1,1,0,37,0,0.003445
1270909994,1270909994,,0,0,0,0,0,0,0,0,0,0,531,0,0
3086538692,3086538692,,0,1,1,0,1,1,1,1,1,0,28,0,0
893436086,893436086,,0,1,1,0,1,1,1,1,1,0,15,0,0.001469
255552313,255552313,,0,1,1,0,1,1,1,1,1,0,28,0,0.000001
840812828965666816,840812828965666816,,0,1,1,0,1,1,2,0.666667,0.75,0,13,0,0.017924
1422480159110803456,1422480159110803456,,0,0,0,0,0,0,0,0,0,0,532,0,0
1407641573752545280,1407641573752545280,,0,1,1,0,1,1,1,1,1,0,37,0,0.003445
1118030533219508224,1118030533219508224,,0,1,1,0,1,1,1,1,1,0,37,0,0.003445
1007028370377531392,1007028370377531392,,0,1,1,0,1,1,1,1,1,0,37,0,0.003445
1076779266619121664,1076779266619121664,,0,1,1,0,1,1,1,1,1,0,21,0,0.000866
879083139808800768,879083139808800768,,0,0,0,0,0,0,0,0,0,0,533,0,0
631810976,631810976,,0,1,1,0,1,1,2,0.666667,0.75,0,13,0,0.017924
1252591576402071552,1252591576402071552,,1,0,1,2,0,2,0,0,0,0,33,0,0
1196394905196777472,1196394905196777472,,0,1,1,0,1,1,2,0.666667,0.75,0,13,0,0.017924
2396451839,2396451839,,0,1,1,0,1,1,2,0.666667,0.75,0,13,0,0.017924
1318163231303663616,1318163231303663616,,0,1,1,0,1,1,2,0.666667,0.75,0,33,0,0
3047041918,3047041918,,0,1,1,0,1,1,1,1,1,0,25,0,0.00062
727093983273488384,727093983273488384,,0,1,1,0,1,1,1,1,1,0,18,0,0
744453072601161728,744453072601161728,,0,1,1,0,1,1,1,1,1,0,37,0,0.003445
577353643,577353643,,0,1,1,0,1,1,1,1,1,0,28,0,0.00005
1011603156,1011603156,,0,1,1,0,1,1,2,0.666667,0.75,0,13,0,0.017924
3333764236,3333764236,,0,1,1,0,1,1,1,1,1,0,57,0,0.000035
33160759,33160759,,0,0,0,0,0,0,0,0,0,0,534,0,0
902154767899774976,902154767899774976,,0,0,0,0,0,0,0,0,0,0,535,0,0
1584078793,1584078793,,0,0,0,0,0,0,0,0,0,0,536,0,0
1255589249472135168,1255589249472135168,,0,1,1,0,1,1,1,1,1,0,15,0,0.001469
781030906278604800,781030906278604800,,0,1,1,0,1,1,1,1,1,0,28,0,0.00005
1366060074146406400,1366060074146406400,,0,1,1,0,1,1,1,1,1,0,15,0,0.001469
102803468,102803468,,0,1,1,0,1,1,4,0.37931,0.431818,0,9,0,0.000021
213616021,213616021,,0,1,1,0,1,1,1,1,1,0,57,0,0.000035
1249684227064508416,1249684227064508416,,0,1,1,0,1,1,1,1,1,0,15,0,0.00039
1139149651532242944,1139149651532242944,,0,1,1,0,1,1,1,1,1,0,37,0,0.003445
2679522658,2679522658,,0,1,1,0,1,1,1,1,1,0,57,0,0.000035
1245622704973070336,1245622704973070336,,0,1,1,0,1,1,1,1,1,0,15,0,0.00029
435737042,435737042,,0,1,1,0,1,1,1,1,1,0,5,0,0.000243
1431549373175975936,1431549373175975936,,0,1,1,0,1,1,1,1,1,0,14,0,0.001513
1311584865469562880,1311584865469562880,,0,1,1,0,1,1,1,1,1,0,37,0,0.003445
897184830517121024,897184830517121024,,0,1,1,0,1,1,2,0.666667,0.75,0,13,0,0.017924
2351913283,2351913283,,0,1,1,0,1,1,1,1,1,0,57,0,0.000035
1390041524285607936,1390041524285607936,,0,0,0,0,0,0,0,0,0,0,537,0,0
2570243375,2570243375,,0,0,0,0,0,0,0,0,0,0,538,0,0
1444073532007370752,1444073532007370752,,0,1,1,0,1,1,1,1,1,0,18,0,0
1175813450641170432,1175813450641170432,,0,1,1,0,1,1,2,0.666667,0.75,0,13,0,0.017924
434256379,434256379,,0,0,0,0,0,0,0,0,0,0,539,0,0
277614098,277614098,,0,1,1,0,1,1,2,0.666667,0.75,0,13,0,0.017924
1275369751439724544,1275369751439724544,,0,1,1,0,1,1,2,0.666667,0.75,0,13,0,0.017924
37619931,37619931,,0,0,0,0,0,0,0,0,0,0,540,0,0
447874305,447874305,,0,1,1,0,1,1,1,1,1,0,15,0,0.001469
1045798680584966144,1045798680584966144,,0,0,0,0,0,0,0,0,0,0,541,0,0
4903019061,4903019061,,0,1,1,0,1,1,1,1,1,0,15,0,0.001469
1350749843145322496,1350749843145322496,,0,1,1,0,1,1,2,0.666667,0.75,0,13,0,0.017924
1702836590,1702836590,,0,0,0,0,0,0,0,0,0,0,542,0,0
2262040708,2262040708,,1,0,1,1,0,1,0,0,0,0,28,0,0
1441398930244243456,1441398930244243456,,0,1,1,0,1,1,1,1,1,0,25,0,0.00062
803371786993893376,803371786993893376,,1,0,1,1,0,1,0,0,0,0,13,0,0
1961227394,1961227394,,0,1,1,0,1,1,1,1,1,0,25,0,0.00062
2757403396,2757403396,,0,1,1,0,1,1,1,1,1,0,18,0,0
403629848,403629848,,0,1,1,0,1,1,1,1,1,0,15,0,0.001469
1445322068187299840,1445322068187299840,,0,0,0,0,0,0,0,0,0,0,543,0,0
525196431,525196431,,0,1,1,0,1,1,1,1,1,0,15,0,0.001469
3428127569,3428127569,,0,1,1,0,1,1,3,0.461538,0.527778,0,110,0,0.000024
1070392579,1070392579,,0,1,1,0,1,1,1,1,1,0,17,0,0.000054
2407547034,2407547034,,0,1,1,0,1,1,1,1,1,0,15,0,0.00039
1148476160,1148476160,,0,1,1,0,1,1,1,1,1,0,544,0,0
1268953866,1268953866,,1,0,1,1,0,1,0,0,0,0,544,0,0
1162061900663992320,1162061900663992320,,0,1,1,0,1,1,1,1,1,0,37,0,0.003445
1385368730,1385368730,,0,1,1,0,1,1,1,1,1,0,37,0,0.003445
1055902462140473344,1055902462140473344,,0,0,0,0,0,0,0,0,0,0,545,0,0
2742633963,2742633963,,0,0,0,0,0,0,0,0,0,0,546,0,0
796260694144548864,796260694144548864,,1,0,1,1,0,1,0,0,0,0,15,0,0
355770276,355770276,,0,1,1,0,1,1,1,1,1,0,28,0,0.000001
268307040,268307040,,1,0,1,1,0,1,0,0,0,0,15,0,0
1190578167498579968,1190578167498579968,,0,1,1,0,1,1,1,1,1,0,21,0,0.000866
1087554156,1087554156,,0,1,1,0,1,1,1,1,1,0,547,0,0
1085455423,1085455423,,1,0,1,1,0,1,0,0,0,0,547,0,0
346134737,346134737,,0,1,1,0,1,1,1,1,1,0,28,0,0.000002
1194877129143529472,1194877129143529472,,0,0,0,0,0,0,0,0,0,0,548,0,0
1433690048441069568,1433690048441069568,,0,1,1,0,1,1,1,1,1,0,21,0,0.000866
332740913,332740913,,0,1,1,0,1,1,1,1,1,0,18,0,0
1225450704078278656,1225450704078278656,,0,1,1,0,1,1,1,1,1,0,28,0,0.000001
1348879096936341504,1348879096936341504,,0,1,1,0,1,1,1,1,1,0,15,0,0.000095
1136598418783133696,1136598418783133696,,0,1,1,0,1,1,1,1,1,0,37,0,0.003445
493014010,493014010,,0,1,1,0,1,1,1,1,1,0,18,0,0
1729125788,1729125788,,0,2,2,0,2,2,1,1,1,0,25,0,0.002089
984109345104449536,984109345104449536,,0,1,1,0,1,1,1,1,1,0,21,0,0.000866
3619108397,3619108397,,0,1,1,0,1,1,1,1,1,0,28,0,0.000001
89478345,89478345,,0,1,1,0,1,1,1,1,1,0,15,0,0.001469
1224287141947232256,1224287141947232256,,0,1,1,0,1,1,1,1,1,0,14,0,0.000019
510198126,510198126,,0,1,1,0,1,1,1,1,1,0,28,0,0.000002
2784216706,2784216706,,0,1,1,0,1,1,1,1,1,0,37,0,0.003445
1118606252316217344,1118606252316217344,,0,0,0,0,0,0,0,0,0,0,549,0,0
100517532,100517532,,0,1,1,0,1,1,1,1,1,0,28,0,0.000001
339170797,339170797,,0,1,1,0,1,1,1,1,1,0,15,0,0.001469
1370605363,1370605363,,0,1,1,0,1,1,1,1,1,0,14,0,0.001513
1359869258,1359869258,,0,1,1,0,1,1,1,1,1,0,33,0,0.00003
840335900,840335900,,0,1,1,0,1,1,1,1,1,0,28,0,0
431478856,431478856,,0,1,1,0,1,1,1,1,1,0,25,0,0.00062
1283810416527892480,1283810416527892480,,0,1,1,0,1,1,1,1,1,0,25,0,0.00062
85143600,85143600,,0,1,1,0,1,1,1,1,1,0,378,0,0
1449282674900799488,1449282674900799488,,0,1,1,0,1,1,1,1,1,0,14,0,0.001513
706067859550695424,706067859550695424,,0,1,1,0,1,1,1,1,1,0,28,0,0
1361358167192567808,1361358167192567808,,1,0,1,2,0,2,0,0,0,0,9,0,0
98855762,98855762,,1,0,1,1,0,1,0,0,0,0,9,0,0
939197443073363968,939197443073363968,,0,1,1,0,1,1,1,1,1,0,25,0,0.00062
916356606,916356606,,0,0,0,0,0,0,0,0,0,0,550,0,0
1288436829436497920,1288436829436497920,,0,1,1,0,1,1,1,1,1,0,17,0,0.000054
224351032,224351032,,0,0,0,0,0,0,0,0,0,0,551,0,0
1918247922,1918247922,,0,1,1,0,1,1,1,1,1,0,28,0,0
3182946159,3182946159,,0,0,0,0,0,0,0,0,0,0,552,0,0
1445040582150299648,1445040582150299648,,0,0,0,0,0,0,0,0,0,0,553,0,0
253595597,253595597,,0,1,1,0,1,1,1,1,1,0,28,0,0.00005
2341755356,2341755356,,0,2,2,0,2,2,3,0.555556,0.666667,0,206,0,0.000018
265593125,265593125,,1,0,1,1,0,1,0,0,0,0,206,0.000001,0
1328806269172518912,1328806269172518912,,0,1,1,0,1,1,1,1,1,0,28,0,0.000001
3037994975,3037994975,,0,1,1,0,1,1,1,1,1,0,28,0,0.00005
705730918,705730918,,0,1,1,0,1,1,1,1,1,0,554,0,0
309277206,309277206,,1,0,1,1,0,1,0,0,0,0,554,0,0
1882803895,1882803895,,0,1,1,0,1,1,1,1,1,0,25,0,0.00062
847963362,847963362,,0,1,1,0,1,1,1,1,1,0,378,0,0
1085517464,1085517464,,0,1,1,0,1,1,1,1,1,0,555,0,0
29045944,29045944,,1,0,1,1,0,1,0,0,0,0,555,0,0
1954952815,1954952815,,0,1,1,0,1,1,1,1,1,0,556,0,0
1275091375474835456,1275091375474835456,,1,0,1,1,0,1,0,0,0,0,556,0,0
368817346,368817346,,0,1,1,0,1,1,1,1,1,0,557,0,0
1898086573,1898086573,,1,0,1,1,0,1,0,0,0,0,557,0,0
96020819,96020819,,0,1,1,0,1,1,2,0.666667,0.75,0,33,0,0
967452291631665152,967452291631665152,,0,1,1,0,1,1,1,1,1,0,14,0,0.000019
3865428028,3865428028,,0,1,1,0,1,1,1,1,1,0,15,0,0.001469
1199327654622707712,1199327654622707712,,0,1,1,0,1,1,1,1,1,0,25,0,0.00062
831768450,831768450,,0,1,1,0,1,1,1,1,1,0,57,0,0.000035
493260423,493260423,,0,0,0,0,0,0,0,0,0,0,558,0,0
50355977,50355977,,1,0,1,1,0,1,0,0,0,0,387,0,0
119648205,119648205,,0,2,2,0,2,2,2,0.75,0.833333,0,33,0,0.000002
2741861003,2741861003,,0,1,1,0,1,1,1,1,1,0,37,0,0.000105
1442073909549944832,1442073909549944832,,0,0,0,0,0,0,0,0,0,0,559,0,0
292831062,292831062,,0,1,1,0,1,1,1,1,1,0,560,0,0
1115218106132119552,1115218106132119552,,2,0,2,2,0,2,0,0,0,0,560,0,0
282603908,282603908,,0,1,1,0,1,1,1,1,1,0,560,0,0
1220332021026885632,1220332021026885632,,0,1,1,0,1,1,1,1,1,0,15,0,0.001469
841724421295476736,841724421295476736,,0,0,0,0,0,0,0,0,0,0,561,0,0
4217482702,4217482702,,0,1,1,0,1,1,1,1,1,0,28,0,0
1628101082,1628101082,,0,1,1,0,1,1,1,1,1,0,57,0,0
1133761049893724160,1133761049893724160,,0,1,1,0,1,1,1,1,1,0,33,0,0
1052857951969525760,1052857951969525760,,6,0,6,6,0,6,0,0,0,0,33,0.000002,0
828344116782256128,828344116782256128,,0,1,1,0,1,1,1,1,1,0,28,0,0
1437371803798839296,1437371803798839296,,0,0,0,0,0,0,0,0,0,0,562,0,0
130502044,130502044,,0,1,1,0,1,1,1,1,1,0,25,0,0.00062
1228335115,1228335115,,0,1,1,0,1,1,1,1,1,0,33,0,0
606120512,606120512,,0,1,1,0,1,1,1,1,1,0,563,0,0
992722506023915520,992722506023915520,,1,0,1,1,0,1,0,0,0,0,563,0,0
1254670813372047360,1254670813372047360,,0,1,1,0,1,1,1,1,1,0,564,0,0
1012085614492176384,1012085614492176384,,2,0,2,2,0,2,0,0,0,0,564,0,0
1153176332,1153176332,,0,2,2,0,2,2,1,1,1,0,15,0,0.002982
881033998008373248,881033998008373248,,0,1,1,0,1,1,1,1,1,0,33,0,0
386096774,386096774,,0,1,1,0,1,1,1,1,1,0,15,0,0.001469
800436732,800436732,,0,1,1,0,1,1,1,1,1,0,25,0,0.00062
1392194521283317760,1392194521283317760,,0,1,1,0,1,1,1,1,1,0,14,0,0.001513
4169202555,4169202555,,0,0,0,0,0,0,0,0,0,0,565,0,0
1556455656,1556455656,,0,1,1,0,1,1,1,1,1,0,28,0,0
4825702601,4825702601,,0,1,1,0,1,1,1,1,1,0,25,0,0.00062
138159406,138159406,,0,1,1,0,1,1,1,1,1,0,21,0,0.000866
2661538973,2661538973,,0,1,1,0,1,1,1,1,1,0,566,0,0
57414988,57414988,,2,0,2,2,0,2,0,0,0,0,566,0,0
3676549834,3676549834,,0,1,1,0,1,1,1,1,1,0,28,0,0
2802425242,2802425242,,0,1,1,0,1,1,1,1,1,0,18,0,0
1292150631717834752,1292150631717834752,,0,0,0,0,0,0,0,0,0,0,567,0,0
1143612202726899712,1143612202726899712,,0,1,1,0,1,1,1,1,1,0,21,0,0.000866
1260616949916151808,1260616949916151808,,0,0,0,0,0,0,0,0,0,0,568,0,0
1438863523631800320,1438863523631800320,,0,1,1,0,1,1,1,1,1,0,18,0,0
1433452165327163392,1433452165327163392,,0,1,1,0,1,1,1,1,1,0,15,0,0.00039
213254229,213254229,,2,2,4,3,4,7,1,1,1,0.000001,206,0,0
986564732,986564732,,1,0,1,1,0,1,0,0,0,0,28,0,0
540066448,540066448,,1,1,2,1,1,2,2,0.666667,0.75,0,33,0,0
1236800418304450560,1236800418304450560,,1,1,2,1,1,2,1,1,1,0,28,0,0
272943074,272943074,,1,0,1,1,0,1,0,0,0,0,28,0,0
1309247718506848256,1309247718506848256,,1,0,1,1,0,1,0,0,0,0,28,0,0
2719186852,2719186852,,1,0,1,1,0,1,0,0,0,0,28,0,0
393646920,393646920,,1,0,1,1,0,1,0,0,0,0,28,0,0
1079154298456551424,1079154298456551424,,1,0,1,1,0,1,0,0,0,0,28,0,0
881001960,881001960,,1,0,1,1,0,1,0,0,0,0,28,0,0
352937036,352937036,,1,0,1,1,0,1,0,0,0,0,28,0,0
192156640,192156640,,0,1,1,0,1,1,1,1,1,0,25,0,0.00062
457615551,457615551,,0,1,1,0,1,1,1,1,1,0,28,0,0
26143609,26143609,,5,0,5,5,0,5,0,0,0,0,28,0,0
1251967746327351296,1251967746327351296,,0,1,1,0,1,1,1,1,1,0,21,0,0.000866
99686196,99686196,,0,3,3,0,10,10,3,0.423077,0.530303,0,206,0,0.000018
2530314205,2530314205,,1,0,1,2,0,2,0,0,0,0,206,0.000001,0
271476597,271476597,,1,0,1,2,0,2,0,0,0,0,206,0.000001,0
1227886183,1227886183,,0,1,1,0,1,1,1,1,1,0,25,0,0.00062
146215776,146215776,,0,1,1,0,1,1,1,1,1,0,57,0,0
435655157,435655157,,0,1,1,0,1,1,1,1,1,0,15,0,0.00039
118331436,118331436,,0,0,0,0,0,0,0,0,0,0,569,0,0
103995289,103995289,,0,1,1,0,1,1,1,1,1,0,14,0,0.001513
2863141785,2863141785,,0,1,1,0,1,1,1,1,1,0,570,0,0
2215404901,2215404901,,2,0,2,2,0,2,0,0,0,0,570,0,0
1316480646357843968,1316480646357843968,,0,0,0,0,0,0,0,0,0,0,571,0,0
1334739001933258752,1334739001933258752,,0,1,1,0,1,1,1,1,1,0,28,0,0
1436572524322639872,1436572524322639872,,0,1,1,0,1,1,1,1,1,0,15,0,0.001469
355122344,355122344,,0,1,1,0,2,2,1,1,1,0,572,0,0
526448857,526448857,,1,0,1,2,0,2,0,0,0,0,572,0,0
2436742697,2436742697,,0,2,2,0,2,2,1,1,1,0,17,0,0.000055
1354101467574112256,1354101467574112256,,0,1,1,0,1,1,1,1,1,0,57,0,0
1470343742,1470343742,,0,1,1,0,1,1,1,1,1,0,57,0,0.000035
1125356343660093440,1125356343660093440,,0,0,0,0,0,0,0,0,0,0,573,0,0
1226428586053251072,1226428586053251072,,0,1,1,0,1,1,1,1,1,0,28,0,0.000002
1431762112326643712,1431762112326643712,,0,1,1,0,1,1,1,1,1,0,28,0,0.00005
2244974332,2244974332,,0,1,1,0,1,1,1,1,1,0,57,0,0
413935857,413935857,,0,1,1,0,1,1,1,1,1,0,15,0,0.001469
588310965,588310965,,0,1,1,0,1,1,1,1,1,0,564,0,0
1431362569,1431362569,,0,1,1,0,1,1,1,1,1,0,15,0,0.001469
780947648798986240,780947648798986240,,0,2,2,0,2,2,1,1,1,0,14,0,0.001515
466071572,466071572,,1,0,1,1,0,1,0,0,0,0,14,0.000044,0
279521903,279521903,,0,1,1,0,1,1,1,1,1,0,25,0,0.00062
1295012991667179520,1295012991667179520,,0,1,1,0,1,1,1,1,1,0,28,0,0
419123819,419123819,,0,0,0,0,0,0,0,0,0,0,574,0,0
3337572016,3337572016,,0,1,1,0,1,1,1,1,1,0,15,0,0.001469
437790658,437790658,,0,1,1,0,1,1,1,1,1,0,37,0,0.003445
401293652,401293652,,0,1,1,0,1,1,1,1,1,0,14,0,0.001513
2214300627,2214300627,,0,0,0,0,0,0,0,0,0,0,575,0,0
1099289419,1099289419,,0,1,1,0,1,1,2,0.666667,0.75,0,33,0,0
466529198,466529198,,0,1,1,0,1,1,1,1,1,0,5,0,0.000018
495045767,495045767,,0,1,1,0,2,2,1,1,1,0,14,0,0.001513
168782371,168782371,,0,1,1,0,1,1,1,1,1,0,37,0,0.000001
410871537,410871537,,0,1,1,0,1,1,1,1,1,0,15,0,0.001469
1090705088342097920,1090705088342097920,,0,0,0,0,0,0,0,0,0,0,576,0,0
818405396335521792,818405396335521792,,1,1,2,1,2,3,1,1,1,0.000008,28,0,0
700516245,700516245,,0,0,0,0,0,0,0,0,0,0,577,0,0
1141403297007460352,1141403297007460352,,0,0,0,0,0,0,0,0,0,0,578,0,0
989340356,989340356,,0,1,1,0,1,1,1,1,1,0,15,0,0.001469
1434391480429338624,1434391480429338624,,0,1,1,0,1,1,1,1,1,0,14,0,0.001513
700901262,700901262,,0,1,1,0,1,1,1,1,1,0,28,0,0
464516274,464516274,,0,2,2,0,2,2,2,0.75,0.833333,0,110,0,0.001479
125851628,125851628,,0,1,1,0,1,1,1,1,1,0,33,0,0
1523064500,1523064500,,0,1,1,0,1,1,1,1,1,0,15,0,0.001469
702497634,702497634,,0,1,1,0,1,1,1,1,1,0,14,0,0.001513
4244881703,4244881703,,0,1,1,0,1,1,1,1,1,0,25,0,0.00062
3040262226,3040262226,,0,1,1,0,1,1,1,1,1,0,28,0,0.000001
1258705664681132032,1258705664681132032,,0,1,1,0,1,1,1,1,1,0,15,0,0
2858887492,2858887492,,0,1,1,0,1,1,2,0.666667,0.75,0,33,0,0
2635093335,2635093335,,0,1,1,0,1,1,1,1,1,0,15,0,0.001469
853265628509155328,853265628509155328,,0,1,1,0,1,1,1,1,1,0,28,0,0.000001
912997249378025472,912997249378025472,,0,2,2,0,2,2,1,1,1,0,28,0,0.000054
1320936355,1320936355,,0,1,1,0,1,1,1,1,1,0,15,0,0.001469
1234855806631399424,1234855806631399424,,0,1,1,0,1,1,1,1,1,0,28,0,0.000002
1255051621005963264,1255051621005963264,,0,1,1,0,1,1,1,1,1,0,33,0,0.00003
3408393521,3408393521,,0,1,1,0,1,1,1,1,1,0,28,0,0
1439863315472261120,1439863315472261120,,0,1,1,0,1,1,1,1,1,0,28,0,0.00005
507479624,507479624,,0,1,1,0,1,1,1,1,1,0,579,0,0
765596494380531712,765596494380531712,,1,0,1,1,0,1,0,0,0,0,579,0,0
2377247953,2377247953,,0,1,1,0,1,1,1,1,1,0,28,0,0
446090752,446090752,,0,0,0,0,0,0,0,0,0,0,580,0,0
309901708,309901708,,0,1,1,0,1,1,1,1,1,0,28,0,0.000002
1290264620184330240,1290264620184330240,,0,1,1,0,1,1,1,1,1,0,15,0,0.001469
190571881,190571881,,0,1,1,0,1,1,1,1,1,0,15,0,0.001469
1422924483543846912,1422924483543846912,,0,1,1,0,1,1,1,1,1,0,15,0,0.00039
502941342,502941342,,0,1,1,0,1,1,1,1,1,0,28,0,0.000002
427299130,427299130,,0,1,1,0,1,1,1,1,1,0,15,0,0.001469
3003900628,3003900628,,0,1,1,0,1,1,1,1,1,0,15,0,0.001469
45439845,45439845,,0,0,0,0,0,0,0,0,0,0,581,0,0
1046481137923751936,1046481137923751936,,0,1,1,0,1,1,1,1,1,0,28,0,0.000001
1017105506,1017105506,,0,1,1,0,1,1,1,1,1,0,15,0,0.001469
1171375543,1171375543,,1,0,1,2,0,2,0,0,0,0,28,0,0
1071542436,1071542436,,0,1,1,0,1,1,1,1,1,0,33,0,0
1520319049,1520319049,,0,1,1,0,1,1,1,1,1,0,14,0,0.000019
161977331,161977331,,0,1,1,0,1,1,1,1,1,0,25,0,0.00062
965593295752744960,965593295752744960,,0,1,1,0,1,1,1,1,1,0,15,0,0.001469
923462492117962752,923462492117962752,,0,1,1,0,1,1,1,1,1,0,28,0,0.000001
1500606428,1500606428,,0,1,1,0,1,1,1,1,1,0,456,0,0
429063865,429063865,,0,1,1,0,1,1,1,1,1,0,15,0,0.001469
1215850226,1215850226,,0,1,1,0,1,1,1,1,1,0,33,0,0.00003
1425058544504741888,1425058544504741888,,0,1,1,0,1,1,1,1,1,0,14,0,0.001513
537380713,537380713,,0,1,1,0,1,1,1,1,1,0,28,0,0
1318897277822504960,1318897277822504960,,0,1,1,0,1,1,1,1,1,0,15,0,0.001469
462417241,462417241,,0,1,1,0,1,1,1,1,1,0,28,0,0
483882275,483882275,,0,1,1,0,1,1,1,1,1,0,28,0,0.00005
289844002,289844002,,0,1,1,0,1,1,1,1,1,0,28,0,0
923188125870026752,923188125870026752,,0,1,1,0,2,2,1,1,1,0,582,0,0
936284727794860032,936284727794860032,,3,0,3,6,0,6,0,0,0,0,582,0,0
14358973,14358973,,0,0,0,0,0,0,0,0,0,0,583,0,0
2646545634,2646545634,,0,1,1,0,1,1,1,1,1,0,28,0,0.000002
1323480472207478784,1323480472207478784,,0,0,0,0,0,0,0,0,0,0,584,0,0
1107930478202552320,1107930478202552320,,0,1,1,0,1,1,1,1,1,0,28,0,0.00005
1399603610305150976,1399603610305150976,,0,1,1,0,1,1,1,1,1,0,28,0,0
80650109,80650109,,0,1,1,0,1,1,1,1,1,0,28,0,0.000002
387065038,387065038,,0,0,0,0,0,0,0,0,0,0,585,0,0
138400776,138400776,,0,1,1,0,3,3,1,1,1,0,28,0,0
134711523,134711523,,0,0,0,0,0,0,0,0,0,0,586,0,0
2446637409,2446637409,,0,1,1,0,1,1,1,1,1,0,25,0,0.00062
2487864596,2487864596,,0,1,1,0,1,1,1,1,1,0,33,0,0.00003
2480161826,2480161826,,0,2,2,0,2,2,1,1,1,0,28,0,0.00039
153342663,153342663,,0,1,1,0,1,1,1,1,1,0,14,0,0.001513
407883349,407883349,,0,1,1,0,1,1,1,1,1,0,28,0,0.000002
1098257082,1098257082,,0,1,1,0,1,1,1,1,1,0,33,0,0.00003
1435339934450298880,1435339934450298880,,0,1,1,0,1,1,1,1,1,0,25,0,0.00062
1395625295370129408,1395625295370129408,,0,1,1,0,1,1,1,1,1,0,15,0,0.00039
2179948113,2179948113,,0,3,3,0,3,3,1,1,1,0,15,0,0.002523
1003877589583319040,1003877589583319040,,0,1,1,0,1,1,1,1,1,0,14,0,0.001513
2379187699,2379187699,,0,1,1,0,1,1,1,1,1,0,33,0,0.00003
177132864,177132864,,0,1,1,0,1,1,1,1,1,0,15,0,0.001469
1259795247925690368,1259795247925690368,,0,1,1,0,1,1,1,1,1,0,15,0,0.001469
491142862,491142862,,0,1,1,0,1,1,2,0.666667,0.75,0,33,0,0
1033719083445964800,1033719083445964800,,0,1,1,0,1,1,1,1,1,0,14,0,0.000001
1011334508,1011334508,,0,1,1,0,1,1,1,1,1,0,33,0,0.00003
1295101627,1295101627,,0,1,1,0,1,1,1,1,1,0,33,0,0.00003
837019878611685376,837019878611685376,,0,1,1,0,1,1,1,1,1,0,25,0,0.00062
4571171663,4571171663,,0,2,2,0,2,2,1,1,1,0,33,0,0.00003
836625982006124544,836625982006124544,,0,1,1,0,1,1,1,1,1,0,15,0,0.00029
1385903750884298752,1385903750884298752,,0,1,1,0,1,1,1,1,1,0,28,0,0
2181350695,2181350695,,0,1,1,0,1,1,1,1,1,0,28,0,0.000002
2219021691,2219021691,,0,1,1,0,1,1,1,1,1,0,17,0,0.000054
2239941328,2239941328,,0,1,1,0,1,1,1,1,1,0,25,0,0.00062
773240110120927232,773240110120927232,,0,1,1,0,1,1,1,1,1,0,25,0,0.00062
429928689,429928689,,0,1,1,0,1,1,1,1,1,0,28,0,0.000002
817732953233035264,817732953233035264,,0,1,1,0,1,1,1,1,1,0,14,0,0.000019
1303175739538395136,1303175739538395136,,0,1,1,0,1,1,1,1,1,0,25,0,0.00062
146592570,146592570,,0,1,1,0,1,1,1,1,1,0,14,0,0.000019
716566384835170304,716566384835170304,,0,0,0,0,0,0,0,0,0,0,587,0,0
3343776015,3343776015,,0,1,1,0,1,1,1,1,1,0,15,0,0.00039
107720168,107720168,,0,1,1,0,1,1,1,1,1,0,25,0,0.00062
1117755210225549312,1117755210225549312,,0,0,0,0,0,0,0,0,0,0,588,0,0
1249837503760269312,1249837503760269312,,0,1,1,0,1,1,2,0.666667,0.75,0,21,0,0.000111
3469818118,3469818118,,0,1,1,0,1,1,1,1,1,0,28,0,0
41545630,41545630,,0,1,1,0,1,1,1,1,1,0,523,0,0
837026309230428160,837026309230428160,,0,1,1,0,1,1,1,1,1,0,28,0,0.000001
1000413697007915008,1000413697007915008,,0,1,1,0,1,1,1,1,1,0,37,0,0.003445
434481487,434481487,,0,1,1,0,1,1,1,1,1,0,33,0,0.00003
381128944,381128944,,0,1,1,0,1,1,1,1,1,0,33,0,0.00003
44857450,44857450,,0,0,0,0,0,0,0,0,0,0,589,0,0
351555225,351555225,,0,2,2,0,2,2,1,1,1,0,14,0,0.004958
1378453257316667392,1378453257316667392,,0,1,1,0,1,1,2,0.6,0.666667,0,718,0,0
319831388,319831388,,2,2,4,2,4,6,1,1,1,0,718,0,0
2416492224,2416492224,,0,1,1,0,1,1,1,1,1,0,110,0,0.000001
475383350,475383350,,0,1,1,0,1,1,1,1,1,0,590,0,0
774625071059050496,774625071059050496,,1,0,1,1,0,1,0,0,0,0,590,0,0
2951349335,2951349335,,0,1,1,0,1,1,1,1,1,0,33,0,0.00003
977689806762373120,977689806762373120,,0,1,1,0,1,1,1,1,1,0,18,0,0
625871628,625871628,,0,1,1,0,1,1,1,1,1,0,15,0,0.001469
786334274232254464,786334274232254464,,0,1,1,0,1,1,1,1,1,0,14,0,0.000019
72345365,72345365,,0,1,1,0,1,1,1,1,1,0,15,0,0.001469
2287036399,2287036399,,0,1,1,0,1,1,1,1,1,0,591,0,0
4577632036,4577632036,,2,0,2,2,0,2,0,0,0,0,591,0,0
1014149572669657088,1014149572669657088,,0,1,1,0,1,1,1,1,1,0,14,0,0.001513
426719729,426719729,,0,0,0,0,0,0,0,0,0,0,592,0,0
1059739956623654912,1059739956623654912,,0,0,0,0,0,0,0,0,0,0,593,0,0
3039726772,3039726772,,0,1,1,0,1,1,1,1,1,0,28,0,0
1342522149513400320,1342522149513400320,,0,1,1,0,1,1,1,1,1,0,25,0,0.00062
2463073418,2463073418,,0,2,2,0,2,2,1,1,1,0,15,0,0.000006
467297743,467297743,,0,1,1,0,1,1,1,1,1,0,28,0,0.000001
267986234,267986234,,0,1,1,0,1,1,1,1,1,0,33,0,0.00003
1281924583906521088,1281924583906521088,,0,0,0,0,0,0,0,0,0,0,594,0,0
930162979,930162979,,0,1,1,0,1,1,1,1,1,0,33,0,0.00003
3407360374,3407360374,,0,1,1,0,1,1,1,1,1,0,18,0,0
111410336,111410336,,0,1,1,0,1,1,1,1,1,0,33,0,0.00003
747634158357323776,747634158357323776,,0,1,1,0,1,1,1,1,1,0,28,0,0.000001
1242851976368578560,1242851976368578560,,0,1,1,0,1,1,1,1,1,0,28,0,0
770218661382647808,770218661382647808,,0,1,1,0,1,1,1,1,1,0,25,0,0.00062
840300946555056128,840300946555056128,,0,1,1,0,1,1,1,1,1,0,28,0,0.000002
2811224137,2811224137,,0,1,1,0,1,1,1,1,1,0,15,0,0.000047
949217047078162432,949217047078162432,,0,1,1,0,1,1,1,1,1,0,19,0,0
1297115748972855296,1297115748972855296,,0,2,2,0,2,2,1,1,1,0,28,0,0.00003
1078998944,1078998944,,0,1,1,0,1,1,1,1,1,0,28,0,0.000001
1426933928443760640,1426933928443760640,,0,1,1,0,1,1,1,1,1,0,15,0,0.001469
2985880540,2985880540,,0,1,1,0,1,1,1,1,1,0,28,0,0.000001
366228620,366228620,,0,1,1,0,1,1,1,1,1,0,28,0,0
756624676894507008,756624676894507008,,0,1,1,0,1,1,1,1,1,0,28,0,0.00005
417897223,417897223,,0,1,1,0,1,1,1,1,1,0,37,0,0.003445
450556892,450556892,,0,1,1,0,1,1,1,1,1,0,33,0,0
712856090,712856090,,0,0,0,0,0,0,0,0,0,0,595,0,0
835122590,835122590,,0,1,1,0,1,1,1,1,1,0,33,0,0.00003
99373477,99373477,,0,1,1,0,1,1,1,1,1,0,37,0,0.003445
779713870877384704,779713870877384704,,0,2,2,0,2,2,2,0.75,0.833333,0,33,0,0
2308979695,2308979695,,0,1,1,0,1,1,1,1,1,0,25,0,0.00062
746394305942683648,746394305942683648,,0,0,0,0,0,0,0,0,0,0,596,0,0
1020249080444964864,1020249080444964864,,0,1,1,0,1,1,1,1,1,0,28,0,0.000001
1277389464,1277389464,,0,1,1,0,1,1,1,1,1,0,33,0,0.00003
1195812517131554816,1195812517131554816,,0,1,1,0,1,1,1,1,1,0,14,0,0.000019
585305153,585305153,,0,1,1,0,1,1,1,1,1,0,28,0,0.00005
1557514573,1557514573,,1,0,1,2,0,2,0,0,0,0,18,0,0
599343100,599343100,,0,1,1,0,1,1,1,1,1,0,321,0,0
193642197,193642197,,0,1,1,0,1,1,1,1,1,0,37,0,0.000105
1130573780,1130573780,,0,1,1,0,1,1,1,1,1,0,28,0,0.000002
603916241,603916241,,0,1,1,0,1,1,1,1,1,0,28,0,0.000002
2397689598,2397689598,,0,1,1,0,1,1,1,1,1,0,14,0,0.001513
2782232782,2782232782,,0,1,1,0,1,1,1,1,1,0,15,0,0.00015
1324086067973312512,1324086067973312512,,0,1,1,0,1,1,1,1,1,0,37,0,0.003445
512331667,512331667,,0,1,1,0,1,1,1,1,1,0,37,0,0.000105
487430671,487430671,,0,1,1,0,1,1,1,1,1,0,37,0,0.000105
1410302595902717952,1410302595902717952,,0,3,3,0,5,5,2,0.714286,0.8,0,17,0,0.000055
251136036,251136036,,1,2,3,2,4,6,1,1,1,0,17,0.000002,0
317659038,317659038,,1,0,1,2,0,2,0,0,0,0,17,0.000002,0
114317541,114317541,,0,1,1,0,1,1,1,1,1,0,17,0,0.000054
3121881723,3121881723,,0,1,1,0,1,1,1,1,1,0,14,0,0.001513
3153471621,3153471621,,0,2,2,0,2,2,1,1,1,0,597,0,0
2202757902,2202757902,,1,0,1,1,0,1,0,0,0,0,597,0,0
614524349,614524349,,1,0,1,1,0,1,0,0,0,0,597,0,0
103049563,103049563,,0,1,1,0,1,1,1,1,1,0,28,0,0.000002
41575951,41575951,,0,0,0,0,0,0,0,0,0,0,598,0,0
995234560211382272,995234560211382272,,0,1,1,0,1,1,1,1,1,0,28,0,0
618244710,618244710,,0,1,1,0,1,1,1,1,1,0,33,0,0.00003
313952386,313952386,,0,1,1,0,1,1,1,1,1,0,28,0,0.000001
1137405619,1137405619,,0,2,2,0,2,2,1,1,1,0,37,0,0.000197
2417919919,2417919919,,0,0,0,0,0,0,0,0,0,0,599,0,0
944246628956950528,944246628956950528,,0,1,1,0,1,1,1,1,1,0,28,0,0.000001
2324022020,2324022020,,0,1,1,0,1,1,1,1,1,0,28,0,0.00005
342550420,342550420,,0,1,1,0,1,1,1,1,1,0,28,0,0
978640426528837632,978640426528837632,,0,1,1,0,1,1,1,1,1,0,15,0,0.00039
983029531,983029531,,0,1,1,0,1,1,1,1,1,0,28,0,0.000001
428533928,428533928,,0,1,1,0,1,1,1,1,1,0,28,0,0
970953303839465472,970953303839465472,,0,1,1,0,1,1,1,1,1,0,28,0,0
1203597456031834112,1203597456031834112,,0,1,1,0,1,1,1,1,1,0,28,0,0.000001
1087715590691794944,1087715590691794944,,0,1,1,0,1,1,1,1,1,0,28,0,0.000001
1344821516,1344821516,,0,1,1,0,1,1,1,1,1,0,250,0,0
960770054,960770054,,0,0,0,0,0,0,0,0,0,0,600,0,0
222628269,222628269,,0,1,1,0,1,1,1,1,1,0,28,0,0.000002
1305864982966525952,1305864982966525952,,0,0,0,0,0,0,0,0,0,0,601,0,0
1179773631431401472,1179773631431401472,,0,1,1,0,1,1,1,1,1,0,17,0,0.000054
53802973,53802973,,0,1,1,0,1,1,1,1,1,0,15,0,0.001469
1379171925663100928,1379171925663100928,,0,0,0,0,0,0,0,0,0,0,602,0,0
329562630,329562630,,0,1,1,0,1,1,1,1,1,0,14,0,0.001513
120072229,120072229,,0,1,1,0,1,1,1,1,1,0,15,0,0.001469
2240735461,2240735461,,0,1,1,0,1,1,1,1,1,0,15,0,0.00039
554513627,554513627,,0,1,1,0,1,1,1,1,1,0,603,0,0
401581073,401581073,,1,0,1,1,0,1,0,0,0,0,603,0,0
244869589,244869589,,0,1,1,0,1,1,1,1,1,0,28,0,0
815921760,815921760,,0,0,0,0,0,0,0,0,0,0,604,0,0
2847895318,2847895318,,0,0,0,0,0,0,0,0,0,0,605,0,0
162003515,162003515,,0,0,0,0,0,0,0,0,0,0,606,0,0
1340066966,1340066966,,0,1,1,0,1,1,1,1,1,0,28,0,0.000002
573442136,573442136,,0,1,1,0,1,1,1,1,1,0,14,0,0.001513
1447311276762337280,1447311276762337280,,0,1,1,0,1,1,1,1,1,0,25,0,0.00062
3937406775,3937406775,,0,1,1,0,1,1,1,1,1,0,19,0,0
33179713,33179713,,0,1,1,0,1,1,1,1,1,0,28,0,0.000002
939250620611080192,939250620611080192,,0,1,1,0,1,1,1,1,1,0,28,0,0.000001
1362837201990615040,1362837201990615040,,0,1,1,0,1,1,1,1,1,0,33,0,0.00003
1056321552,1056321552,,0,1,1,0,1,1,1,1,1,0,28,0,0
1026497870181089280,1026497870181089280,,0,1,1,0,1,1,1,1,1,0,18,0,0
3121028094,3121028094,,0,1,1,0,1,1,1,1,1,0,28,0,0.00005
4838046849,4838046849,,0,1,1,0,1,1,1,1,1,0,456,0,0
195884745,195884745,,0,1,1,0,1,1,1,1,1,0,15,0,0.001469
1157043744,1157043744,,0,1,1,0,1,1,1,1,1,0,33,0,0.00003
55264085,55264085,,0,1,1,0,1,1,1,1,1,0,607,0,0
91352489,91352489,,1,0,1,1,0,1,0,0,0,0,607,0,0
494358540,494358540,,0,1,1,0,1,1,1,1,1,0,25,0,0.00062
10472252,10472252,,0,0,0,0,0,0,0,0,0,0,608,0,0
701788479722749952,701788479722749952,,0,1,1,0,1,1,1,1,1,0,37,0,0.003445
1160852194117201920,1160852194117201920,,0,1,1,0,1,1,1,1,1,0,28,0,0
2500421962,2500421962,,0,1,1,0,1,1,1,1,1,0,18,0,0
4063692863,4063692863,,0,1,1,0,1,1,1,1,1,0,15,0,0.000279
27436503,27436503,,0,1,1,0,1,1,1,1,1,0,28,0,0
1383477559573110784,1383477559573110784,,0,1,1,0,1,1,1,1,1,0,25,0,0.00062
2490640097,2490640097,,0,1,1,0,1,1,1,1,1,0,25,0,0.00062
950822483770462208,950822483770462208,,0,1,1,0,1,1,1,1,1,0,14,0,0.001513
2201962850,2201962850,,0,1,1,0,1,1,1,1,1,0,33,0,0.00003
724303327077502976,724303327077502976,,0,1,1,0,1,1,1,1,1,0,33,0,0.00003
3394479556,3394479556,,0,1,1,0,1,1,1,1,1,0,15,0,0.000279
3093711834,3093711834,,0,2,2,0,4,4,1,1,1,0,609,0,0
2238273522,2238273522,,1,0,1,2,0,2,0,0,0,0,609,0,0
1510018086,1510018086,,1,0,1,2,0,2,0,0,0,0,609,0,0
410546133,410546133,,0,1,1,0,1,1,1,1,1,0,28,0,0.000002
3323385291,3323385291,,0,1,1,0,1,1,1,1,1,0,5,0,0.000243
30520601,30520601,,0,1,1,0,1,1,2,0.666667,0.75,0,33,0,0
2977945563,2977945563,,0,1,1,0,1,1,1,1,1,0,15,0,0.001469
1297313027189084160,1297313027189084160,,0,0,0,0,0,0,0,0,0,0,610,0,0
2803957169,2803957169,,0,1,1,0,1,1,1,1,1,0,15,0,0.001469
912792614843355136,912792614843355136,,0,1,1,0,1,1,1,1,1,0,25,0,0.00062
1232250772882182144,1232250772882182144,,0,1,1,0,1,1,1,1,1,0,25,0,0.00062
1070911692,1070911692,,0,1,1,0,1,1,1,1,1,0,15,0,0.001469
628367790,628367790,,0,1,1,0,1,1,1,1,1,0,17,0,0.000054
2365644817,2365644817,,0,0,0,0,0,0,0,0,0,0,611,0,0
2847010691,2847010691,,0,1,1,0,1,1,1,1,1,0,612,0,0
626360641,626360641,,1,0,1,1,0,1,0,0,0,0,612,0,0
1332185558,1332185558,,0,1,1,0,1,1,1,1,1,0,28,0,0.00005
478717091,478717091,,0,1,1,0,1,1,1,1,1,0,28,0,0.000001
1268138691920375808,1268138691920375808,,0,1,1,0,1,1,1,1,1,0,33,0,0
268864676,268864676,,0,1,1,0,1,1,1,1,1,0,28,0,0
3297666816,3297666816,,0,1,1,0,1,1,1,1,1,0,17,0,0.000054
763473749861625856,763473749861625856,,0,1,1,0,1,1,1,1,1,0,28,0,0.000001
1281771329239363584,1281771329239363584,,0,1,1,0,1,1,1,1,1,0,25,0,0.00062
606976872,606976872,,0,0,0,0,0,0,0,0,0,0,613,0,0
703386818,703386818,,0,1,1,0,1,1,1,1,1,0,28,0,0
956218128,956218128,,0,1,1,0,1,1,1,1,1,0,28,0,0
1185037188855148544,1185037188855148544,,0,1,1,0,1,1,1,1,1,0,614,0,0
2415388679,2415388679,,1,0,1,1,0,1,0,0,0,0,614,0,0
900608272679538688,900608272679538688,,0,1,1,0,1,1,1,1,1,0,110,0,0.000001
2489904199,2489904199,,0,1,1,0,1,1,1,1,1,0,28,0,0.000001
2955103529,2955103529,,0,1,1,0,1,1,1,1,1,0,615,0,0
526530582,526530582,,1,0,1,1,0,1,0,0,0,0,615,0,0
205888140,205888140,,0,1,1,0,1,1,1,1,1,0,14,0,0.001513
2390676985,2390676985,,0,1,1,0,1,1,1,1,1,0,14,0,0.001513
772050153968721920,772050153968721920,,0,1,1,0,1,1,1,1,1,0,28,0,0.000001
411480461,411480461,,0,1,1,0,1,1,2,0.666667,0.75,0,619,0,0
376688279,376688279,,1,1,2,1,4,5,1,1,1,0,619,0,0
1401967265038405632,1401967265038405632,,0,1,1,0,1,1,1,1,1,0,15,0,0.00039
1428679992796401664,1428679992796401664,,0,1,1,0,1,1,1,1,1,0,37,0,0.003445
1011351750,1011351750,,0,1,1,0,1,1,2,0.666667,0.75,0,21,0,0.000111
1016972637975793664,1016972637975793664,,0,0,0,0,0,0,0,0,0,0,616,0,0
1063743655889068032,1063743655889068032,,0,1,1,0,1,1,1,1,1,0,57,0,0.000035
1101405657050304512,1101405657050304512,,0,0,0,0,0,0,0,0,0,0,617,0,0
101445331,101445331,,0,0,0,0,0,0,0,0,0,0,618,0,0
3151825048,3151825048,,1,0,1,4,0,4,0,0,0,0,619,0,0
207894729,207894729,,0,1,1,0,1,1,2,0.666667,0.75,0,21,0,0.000111
3303118563,3303118563,,0,1,1,0,1,1,1,1,1,0,18,0,0
1082711051249029120,1082711051249029120,,0,1,1,0,1,1,1,1,1,0,28,0,0
3043319912,3043319912,,0,1,1,0,1,1,1,1,1,0,28,0,0
253967768,253967768,,2,0,2,2,0,2,0,0,0,0,28,0,0
721338196639014912,721338196639014912,,0,1,1,0,1,1,1,1,1,0,591,0,0
2340302399,2340302399,,0,1,1,0,1,1,1,1,1,0,28,0,0.000001
1055494906133839872,1055494906133839872,,0,1,1,0,1,1,1,1,1,0,28,0,0.000001
1402688845,1402688845,,0,1,1,0,1,1,1,1,1,0,5,0,0.000062
444716468,444716468,,0,1,1,0,1,1,1,1,1,0,18,0,0
900242237329727488,900242237329727488,,0,1,1,0,1,1,1,1,1,0,28,0,0
1712653148,1712653148,,0,1,1,0,1,1,1,1,1,0,33,0,0.00003
213785823,213785823,,0,1,1,0,1,1,1,1,1,0,15,0,0.00039
515584116,515584116,,0,1,1,0,4,4,1,1,1,0,620,0,0
3775808595,3775808595,,1,0,1,4,0,4,0,0,0,0,620,0,0
1595762172,1595762172,,0,0,0,0,0,0,0,0,0,0,621,0,0
429085080,429085080,,0,1,1,0,1,1,1,1,1,0,15,0,0.000001
1750185974,1750185974,,0,1,1,0,1,1,1,1,1,0,15,0,0.00039
82092954,82092954,,0,0,0,0,0,0,0,0,0,0,622,0,0
1420497721,1420497721,,0,0,0,0,0,0,0,0,0,0,623,0,0
828266996915658752,828266996915658752,,0,1,1,0,1,1,1,1,1,0,25,0,0.00062
3143810488,3143810488,,0,2,2,0,3,3,1,1,1,0,21,0,0.000022
1309160994996916224,1309160994996916224,,1,0,1,2,0,2,0,0,0,0,21,0.000001,0
1446916688805515264,1446916688805515264,,0,0,0,0,0,0,0,0,0,0,624,0,0
2764203485,2764203485,,0,1,1,0,1,1,1,1,1,0,19,0,0.000038
944009766938075136,944009766938075136,,0,1,1,0,1,1,1,1,1,0,37,0,0.003445
327417226,327417226,,0,1,1,0,1,1,2,0.666667,0.75,0,21,0,0.000111
2924811100,2924811100,,0,0,0,0,0,0,0,0,0,0,625,0,0
1214288976518905856,1214288976518905856,,0,1,1,0,1,1,1,1,1,0,25,0,0.00062
1219298065951133696,1219298065951133696,,1,0,1,2,0,2,0,0,0,0,15,0,0
897150701381582848,897150701381582848,,1,0,1,2,0,2,0,0,0,0,15,0,0
212947664,212947664,,0,1,1,0,1,1,1,1,1,0,33,0,0
397195262,397195262,,0,0,0,0,0,0,0,0,0,0,626,0,0
859135204933476352,859135204933476352,,0,1,1,0,1,1,1,1,1,0,33,0,0.00003
1118119168975544320,1118119168975544320,,0,0,0,0,0,0,0,0,0,0,627,0,0
259254286,259254286,,0,1,1,0,1,1,1,1,1,0,33,0,0
1258363856168124416,1258363856168124416,,0,1,1,0,1,1,1,1,1,0,17,0,0.000054
543814633,543814633,,0,0,0,0,0,0,0,0,0,0,628,0,0
52337911,52337911,,0,1,1,0,1,1,1,1,1,0,15,0,0.000036
1162323121,1162323121,,0,1,1,0,1,1,1,1,1,0,28,0,0.000002
1432997277753389056,1432997277753389056,,0,0,0,0,0,0,0,0,0,0,629,0,0
2225222260,2225222260,,0,1,1,0,1,1,1,1,1,0,25,0,0.00062
39475962,39475962,,0,1,1,0,1,1,1,1,1,0,28,0,0
1074705704953569280,1074705704953569280,,0,0,0,0,0,0,0,0,0,0,630,0,0
1327763869440339968,1327763869440339968,,0,1,1,0,1,1,1,1,1,0,28,0,0.000001
2560818481,2560818481,,0,1,1,0,1,1,2,0.666667,0.75,0,21,0,0.000111
101280803,101280803,,0,0,0,0,0,0,0,0,0,0,631,0,0
1024050070881271808,1024050070881271808,,0,1,1,0,1,1,1,1,1,0,33,0,0.00003
452951343,452951343,,0,1,1,0,1,1,1,1,1,0,33,0,0.00003
1566329647,1566329647,,0,0,0,0,0,0,0,0,0,0,632,0,0
165765384,165765384,,0,1,1,0,1,1,1,1,1,0,28,0,0.000002
2956811146,2956811146,,0,1,1,0,1,1,1,1,1,0,28,0,0
450654477,450654477,,0,1,1,0,1,1,1,1,1,0,28,0,0
933984187790618624,933984187790618624,,0,1,1,0,1,1,1,1,1,0,28,0,0.000001
429279647,429279647,,0,1,1,0,1,1,1,1,1,0,28,0,0
1038189569311735808,1038189569311735808,,0,1,1,0,1,1,1,1,1,0,28,0,0.000001
34960001,34960001,,0,1,1,0,1,1,1,1,1,0,28,0,0.000002
979747878347386880,979747878347386880,,0,1,1,0,1,1,1,1,1,0,28,0,0.000002
469679477,469679477,,0,0,0,0,0,0,0,0,0,0,633,0,0
526309670,526309670,,0,1,1,0,1,1,1,1,1,0,28,0,0
1066354130,1066354130,,0,1,1,0,1,1,1,1,1,0,28,0,0.000001
45514913,45514913,,0,1,1,0,1,1,1,1,1,0,28,0,0.000001
854631205828001792,854631205828001792,,0,1,1,0,1,1,1,1,1,0,28,0,0.000001
920148273507258368,920148273507258368,,0,1,1,0,2,2,1,1,1,0,582,0,0
833480083562192896,833480083562192896,,0,0,0,0,0,0,0,0,0,0,634,0,0
2349495047,2349495047,,0,1,1,0,1,1,1,1,1,0,57,0,0.000035
1220811823,1220811823,,0,1,1,0,1,1,1,1,1,0,635,0,0
622708061,622708061,,1,0,1,1,0,1,0,0,0,0,635,0,0
2935781224,2935781224,,0,1,1,0,1,1,1,1,1,0,28,0,0.00005
1248692956414050304,1248692956414050304,,0,3,3,0,6,6,1,1,1,0,206,0,0
461306712,461306712,,1,0,1,2,0,2,0,0,0,0,206,0,0
429312499,429312499,,2,0,2,4,0,4,0,0,0,0,206,0,0
154082631,154082631,,1,0,1,2,0,2,0,0,0,0,206,0,0
1448722391656538112,1448722391656538112,,0,2,2,0,3,3,2,0.666667,0.75,0,718,0,0
2652060368,2652060368,,1,0,1,2,0,2,0,0,0,0,718,0,0
273651218,273651218,,0,1,1,0,1,1,1,1,1,0,13,0,0.000066
470622822,470622822,,0,1,1,0,1,1,1,1,1,0,14,0,0.001513
1370748970562166784,1370748970562166784,,0,1,1,0,1,1,1,1,1,0,28,0,0
3301645203,3301645203,,0,0,0,0,0,0,0,0,0,0,636,0,0
1227988316,1227988316,,0,1,1,0,1,1,1,1,1,0,25,0,0.00062
1240191309526302720,1240191309526302720,,0,1,1,0,1,1,1,1,1,0,28,0,0
1371776793083052032,1371776793083052032,,0,1,1,0,1,1,2,0.666667,0.75,0,650,0,0
14367470,14367470,,1,1,2,1,2,3,1,1,1,0,650,0,0
1432452931002019840,1432452931002019840,,0,1,1,0,1,1,1,1,1,0,15,0,0.000036
1140366230,1140366230,,0,2,2,0,3,3,1,1,1,0,637,0,0
1444436155,1444436155,,1,0,1,2,0,2,0,0,0,0,637,0,0
1197801046510309376,1197801046510309376,,1,0,1,1,0,1,0,0,0,0,637,0,0
3381470813,3381470813,,0,1,1,0,1,1,1,1,1,0,33,0,0.00003
116050560,116050560,,0,1,1,0,1,1,1,1,1,0,28,0,0
1449078808364060672,1449078808364060672,,0,0,0,0,0,0,0,0,0,0,638,0,0
4049929390,4049929390,,0,1,1,0,1,1,1,1,1,0,639,0,0
497188910,497188910,,1,0,1,1,0,1,0,0,0,0,639,0,0
1358881598847012864,1358881598847012864,,0,0,0,0,0,0,0,0,0,0,640,0,0
240710359,240710359,,0,1,1,0,1,1,1,1,1,0,110,0,0.000001
1212831226068783104,1212831226068783104,,0,1,1,0,1,1,1,1,1,0,641,0,0
1202641460778143744,1202641460778143744,,1,0,1,1,0,1,0,0,0,0,641,0,0
1338185335948324864,1338185335948324864,,0,1,1,0,1,1,1,1,1,0,14,0,0.001513
1448792509874835456,1448792509874835456,,0,0,0,0,0,0,0,0,0,0,642,0,0
301171038,301171038,,0,1,1,0,1,1,1,1,1,0,643,0,0
14374811,14374811,,1,0,1,1,0,1,0,0,0,0,643,0,0
1522338079,1522338079,,0,1,1,0,1,1,1,1,1,0,570,0,0
2179869467,2179869467,,0,1,1,0,1,1,1,1,1,0,28,0,0.000002
606998051,606998051,,0,1,1,0,1,1,1,1,1,0,25,0,0.00062
72820109,72820109,,0,1,1,0,1,1,1,1,1,0,15,0,0.00039
913036377683578880,913036377683578880,,0,1,1,0,1,1,1,1,1,0,28,0,0.000002
117692398,117692398,,0,1,1,0,1,1,1,1,1,0,28,0,0.000001
1436216805069148160,1436216805069148160,,0,0,0,0,0,0,0,0,0,0,644,0,0
2478507155,2478507155,,0,1,1,0,1,1,1,1,1,0,28,0,0
1176507668,1176507668,,0,1,1,0,1,1,1,1,1,0,33,0,0.00003
851456364,851456364,,0,1,1,0,1,1,1,1,1,0,28,0,0
1382258084567998464,1382258084567998464,,0,1,1,0,1,1,1,1,1,0,15,0,0
397998943,397998943,,0,0,0,0,0,0,0,0,0,0,645,0,0
1447095162367356928,1447095162367356928,,0,0,0,0,0,0,0,0,0,0,646,0,0
885916927331315712,885916927331315712,,0,0,0,0,0,0,0,0,0,0,647,0,0
3300957274,3300957274,,0,1,1,0,1,1,1,1,1,0,28,0,0.000002
2342755451,2342755451,,0,1,1,0,1,1,1,1,1,0,14,0,0.001513
161291032,161291032,,0,1,1,0,1,1,1,1,1,0,477,0,0
1251089251,1251089251,,0,1,1,0,1,1,1,1,1,0,28,0,0
2920002778,2920002778,,0,0,0,0,0,0,0,0,0,0,648,0,0
2428589687,2428589687,,0,1,1,0,1,1,1,1,1,0,37,0,0.000105
1077801097,1077801097,,0,1,1,0,1,1,1,1,1,0,28,0,0.000001
1241746082943700992,1241746082943700992,,0,1,1,0,1,1,1,1,1,0,25,0,0.000018
1070109237861343232,1070109237861343232,,0,1,1,0,1,1,1,1,1,0,57,0,0.000035
962311958,962311958,,0,1,1,0,1,1,1,1,1,0,17,0,0.000054
971365242847617024,971365242847617024,,0,1,1,0,1,1,1,1,1,0,28,0,0
1130865291020439552,1130865291020439552,,0,1,1,0,1,1,1,1,1,0,33,0,0.00003
768880298310402048,768880298310402048,,0,1,1,0,1,1,1,1,1,0,28,0,0.000002
1056454514,1056454514,,0,1,1,0,1,1,1,1,1,0,37,0,0.000005
1095412353427013632,1095412353427013632,,0,1,1,0,1,1,1,1,1,0,14,0,0.001513
902394874367967232,902394874367967232,,0,1,1,0,1,1,1,1,1,0,649,0,0
1407277149531353088,1407277149531353088,,1,0,1,1,0,1,0,0,0,0,649,0,0
1330167710068727808,1330167710068727808,,0,1,1,0,1,1,1,1,1,0,28,0,0.000001
3131686066,3131686066,,0,1,1,0,1,1,1,1,1,0,17,0,0.000054
525396583,525396583,,0,1,1,0,1,1,2,0.666667,0.75,0,33,0,0
444612914,444612914,,1,0,1,2,0,2,0,0,0,0,650,0,0
996571967598813184,996571967598813184,,0,1,1,0,1,1,1,1,1,0,28,0,0.000002
258758131,258758131,,0,1,1,0,1,1,1,1,1,0,28,0,0.000002
1169374199338676224,1169374199338676224,,0,1,1,0,1,1,1,1,1,0,25,0,0.00062
396855139,396855139,,0,0,0,0,0,0,0,0,0,0,651,0,0
1263851995,1263851995,,0,1,1,0,1,1,1,1,1,0,28,0,0.000001
487711174,487711174,,0,1,1,0,1,1,2,0.666667,0.75,0,21,0,0.000111
197763661,197763661,,0,0,0,0,0,0,0,0,0,0,652,0,0
1333741939531935744,1333741939531935744,,0,1,1,0,1,1,1,1,1,0,28,0,0.000001
397199507,397199507,,0,1,1,0,1,1,1,1,1,0,28,0,0.000002
2560173527,2560173527,,0,1,1,0,1,1,1,1,1,0,28,0,0.000002
1668915986,1668915986,,0,1,1,0,1,1,2,0.666667,0.75,0,21,0,0.000111
1290285458308698112,1290285458308698112,,0,1,1,0,1,1,1,1,1,0,15,0,0
1340367966987317248,1340367966987317248,,2,0,2,3,0,3,0,0,0,0,15,0,0
1293418991206256640,1293418991206256640,,0,1,1,0,1,1,1,1,1,0,28,0,0.000001
2865546393,2865546393,,0,0,0,0,0,0,0,0,0,0,653,0,0
2933613009,2933613009,,0,0,0,0,0,0,0,0,0,0,654,0,0
573084578,573084578,,0,1,1,0,1,1,1,1,1,0,566,0,0
3764059997,3764059997,,0,0,0,0,0,0,0,0,0,0,655,0,0
1128333732,1128333732,,0,1,1,0,1,1,1,1,1,0,110,0,0.000001
1274855814,1274855814,,0,1,1,0,1,1,2,0.666667,0.75,0,21,0,0.000111
825707038877577216,825707038877577216,,0,1,1,0,1,1,1,1,1,0,110,0,0.000001
3371019309,3371019309,,0,1,1,0,1,1,1,1,1,0,33,0,0.00003
1438517076625215488,1438517076625215488,,0,2,2,0,4,4,1,1,1,0,656,0,0
311757883,311757883,,1,0,1,2,0,2,0,0,0,0,656,0,0
33502178,33502178,,1,0,1,2,0,2,0,0,0,0,656,0,0
29993740,29993740,,0,1,1,0,2,2,2,0.666667,0.75,0,21,0,0
1166799219509911552,1166799219509911552,,1,0,1,2,0,2,0,0,0,0,21,0,0
1229082078093959168,1229082078093959168,,1,0,1,2,0,2,0,0,0,0,28,0,0
870215469139197952,870215469139197952,,1,0,1,2,0,2,0,0,0,0,28,0,0
87554909,87554909,,0,1,1,0,2,2,2,0.571429,0.625,0,110,0,0.000006
1125830085909544960,1125830085909544960,,1,0,1,2,0,2,0,0,0,0,110,0,0
428573061,428573061,,1,0,1,2,0,2,0,0,0,0,110,0,0
930757704213295104,930757704213295104,,1,0,1,2,0,2,0,0,0,0,110,0,0
734134273,734134273,,1,0,1,2,0,2,0,0,0,0,9,0,0
1238710954780745728,1238710954780745728,,1,0,1,2,0,2,0,0,0,0,9,0,0
54988878,54988878,,1,0,1,2,0,2,0,0,0,0,18,0,0
1001494357,1001494357,,1,0,1,2,0,2,0,0,0,0,18,0,0
108584277,108584277,,1,0,1,2,0,2,0,0,0,0,18,0,0
436188255,436188255,,1,0,1,2,0,2,0,0,0,0,18,0,0
1032566141275840512,1032566141275840512,,1,2,3,2,4,6,1,1,1,0.000005,18,0,0
1451454351529201664,1451454351529201664,,0,1,1,0,2,2,3,0.392857,0.439394,0,206,0,0
1072167411984551936,1072167411984551936,,1,3,4,2,6,8,2,0.588235,0.65,0,206,0,0
232829314,232829314,,1,0,1,2,0,2,0,0,0,0,206,0,0
498226282,498226282,,2,7,9,4,14,18,1,1,1,0.000003,206,0,0
2264138840,2264138840,,1,0,1,2,0,2,0,0,0,0,206,0,0
594745730,594745730,,0,2,2,0,4,4,2,0.625,0.7,0,25,0,0.000036
4136067262,4136067262,,1,0,1,2,0,2,0,0,0,0,25,0.000001,0
722684492,722684492,,2,0,2,4,0,4,0,0,0,0,25,0,0
524523883,524523883,,1,0,1,2,0,2,0,0,0,0,25,0,0
1444327554689667072,1444327554689667072,,1,0,1,2,0,2,0,0,0,0,25,0,0
3246079828,3246079828,,1,0,1,2,0,2,0,0,0,0,9,0,0
1368900804,1368900804,,0,1,1,0,2,2,1,1,1,0,657,0,0
2589482000,2589482000,,1,0,1,2,0,2,0,0,0,0,657,0,0
2363922944,2363922944,,1,0,1,2,0,2,0,0,0,0,250,0.000001,0
2740038942,2740038942,,1,0,1,2,0,2,0,0,0,0,250,0.000001,0
1191645884376911872,1191645884376911872,,0,1,1,0,2,2,1,1,1,0,658,0,0
3543518537,3543518537,,1,0,1,2,0,2,0,0,0,0,658,0,0
411784978,411784978,,0,1,1,0,2,2,1,1,1,0,659,0,0
818866302571921408,818866302571921408,,1,0,1,2,0,2,0,0,0,0,659,0,0
1045175822,1045175822,,1,1,2,2,2,4,1,1,1,0,206,0,0
48334852,48334852,,0,1,1,0,2,2,2,0.666667,0.75,0,660,0,0
447896469,447896469,,1,1,2,2,2,4,1,1,1,0,660,0,0
80262636,80262636,,1,0,1,2,0,2,0,0,0,0,660,0,0
245313164,245313164,,0,1,1,0,2,2,3,0.5,0.541667,0,9,0,0.000001
256602377,256602377,,1,0,1,2,0,2,0,0,0,0,9,0.000001,0
431663224,431663224,,1,1,2,2,2,4,1,1,1,0.000018,9,0.000001,0
3077698763,3077698763,,1,0,1,2,0,2,0,0,0,0,9,0.000001,0
1365608008026361856,1365608008026361856,,1,0,1,2,0,2,0,0,0,0,9,0.000001,0
1038705471736242176,1038705471736242176,,1,0,1,2,0,2,0,0,0,0,9,0.000001,0
2806277961,2806277961,,0,1,1,0,1,1,1,1,1,0,661,0,0
1438818052028739584,1438818052028739584,,1,0,1,1,0,1,0,0,0,0,661,0,0
1354760216349470720,1354760216349470720,,0,1,1,0,2,2,1,1,1,0,662,0,0
263628865,263628865,,1,0,1,2,0,2,0,0,0,0,662,0,0
2299677314,2299677314,,0,2,2,0,4,4,1,1,1,0,17,0,0.000038
987358425955872768,987358425955872768,,1,0,1,2,0,2,0,0,0,0,17,0.000001,0
408683788,408683788,,1,0,1,2,0,2,0,0,0,0,250,0,0
1439687019454738432,1439687019454738432,,1,1,2,2,2,4,1,1,1,0.000003,25,0,0
1142448275649380352,1142448275649380352,,1,0,1,2,0,2,0,0,0,0,25,0,0
1441309312966529024,1441309312966529024,,0,1,1,0,2,2,1,1,1,0,663,0,0
2842400818,2842400818,,1,0,1,2,0,2,0,0,0,0,663,0,0
525409802,525409802,,0,1,1,0,2,2,2,0.666667,0.75,0,28,0,0
2267584281,2267584281,,1,0,1,2,0,2,0,0,0,0,28,0,0
2728974960,2728974960,,0,1,1,0,2,2,1,1,1,0,664,0,0
117059375,117059375,,1,0,1,2,0,2,0,0,0,0,664,0,0
2180427250,2180427250,,0,1,1,0,2,2,2,0.666667,0.75,0,13,0,0
73971750,73971750,,1,1,2,2,2,4,1,1,1,0,13,0,0.000015
519778797,519778797,,0,1,1,0,2,2,1,1,1,0,21,0,0.000034
1433085022794391552,1433085022794391552,,0,1,1,0,2,2,1,1,1,0,665,0,0
1449646427676848128,1449646427676848128,,1,0,1,2,0,2,0,0,0,0,665,0,0
90434897,90434897,,0,1,1,0,2,2,1,1,1,0,666,0,0
70350451,70350451,,1,0,1,2,0,2,0,0,0,0,666,0,0
53796411,53796411,,0,1,1,0,2,2,1,1,1,0,667,0,0
1413996952765730816,1413996952765730816,,1,0,1,2,0,2,0,0,0,0,667,0,0
1238499052364464128,1238499052364464128,,1,0,1,2,0,2,0,0,0,0,9,0,0
210501383,210501383,,1,0,1,2,0,2,0,0,0,0,130,0,0
155734425,155734425,,0,1,1,0,2,2,1,1,1,0,668,0,0
1602046633,1602046633,,1,0,1,2,0,2,0,0,0,0,668,0,0
709150495,709150495,,0,1,1,0,2,2,1,1,1,0,669,0,0
3044664286,3044664286,,1,0,1,2,0,2,0,0,0,0,669,0,0
1901538372,1901538372,,0,1,1,0,2,2,1,1,1,0,670,0,0
2900789860,2900789860,,1,0,1,2,0,2,0,0,0,0,670,0,0
394870816,394870816,,0,1,1,0,2,2,1,1,1,0,671,0,0
864480772715143168,864480772715143168,,1,0,1,2,0,2,0,0,0,0,671,0,0
1077688422012207104,1077688422012207104,,0,1,1,0,2,2,1,1,1,0,672,0,0
437029924,437029924,,1,0,1,2,0,2,0,0,0,0,672,0,0
1164935501612236800,1164935501612236800,,0,1,1,0,1,1,1,1,1,0,673,0,0
3613396888,3613396888,,1,0,1,1,0,1,0,0,0,0,673,0,0
1180633020,1180633020,,0,1,1,0,2,2,1,1,1,0,674,0,0
368907026,368907026,,1,0,1,2,0,2,0,0,0,0,674,0,0
1280198562740084736,1280198562740084736,,1,0,1,2,0,2,0,0,0,0,18,0,0
14153768,14153768,,1,0,1,2,0,2,0,0,0,0,206,0,0
1052556445143707648,1052556445143707648,,2,0,2,4,0,4,0,0,0,0,206,0.000001,0
1333356316631441408,1333356316631441408,,0,1,1,0,2,2,1,1,1,0,28,0,0
1044291763538726912,1044291763538726912,,1,0,1,4,0,4,0,0,0,0,13,0,0
1256957261873852416,1256957261873852416,,1,0,1,2,0,2,0,0,0,0,13,0,0
531243852,531243852,,1,0,1,2,0,2,0,0,0,0,21,0,0
199656773,199656773,,1,1,2,2,2,4,1,1,1,0.000018,110,0,0
875748084,875748084,,1,0,1,2,0,2,0,0,0,0,110,0,0
1295447129553539072,1295447129553539072,,0,1,1,0,2,2,1,1,1,0,675,0,0
1049618472882372608,1049618472882372608,,1,0,1,2,0,2,0,0,0,0,21,0,0
189134612,189134612,,0,1,1,0,2,2,1,1,1,0,28,0,0
376749526,376749526,,1,0,1,2,0,2,0,0,0,0,33,0,0
1448586966237384704,1448586966237384704,,1,0,1,2,0,2,0,0,0,0,21,0.000001,0
1254820502272651264,1254820502272651264,,0,1,1,0,2,2,1,1,1,0,676,0,0
589524594,589524594,,1,0,1,2,0,2,0,0,0,0,676,0,0
1387355480121614336,1387355480121614336,,0,1,1,0,2,2,2,0.666667,0.75,0,110,0,0.000025
983624421930827776,983624421930827776,,2,0,2,4,0,4,0,0,0,0,17,0,0
1446157689978032128,1446157689978032128,,0,1,1,0,2,2,1,1,1,0,677,0,0
1245357873401659392,1245357873401659392,,1,0,1,2,0,2,0,0,0,0,677,0,0
267330192,267330192,,1,0,1,2,0,2,0,0,0,0,18,0,0
334573002,334573002,,0,1,1,0,2,2,2,0.666667,0.75,0,678,0,0
2695436575,2695436575,,1,1,2,2,2,4,1,1,1,0,678,0,0
76622281,76622281,,0,0,0,0,0,0,0,0,0,0,679,0,0
40444498,40444498,,0,1,1,0,2,2,1,1,1,0,680,0,0
748570964439490560,748570964439490560,,1,0,1,2,0,2,0,0,0,0,680,0,0
1132372774612344832,1132372774612344832,,1,0,1,2,0,2,0,0,0,0,250,0,0
362408747,362408747,,1,0,1,1,0,1,0,0,0,0,18,0,0
46078438,46078438,,1,0,1,1,0,1,0,0,0,0,18,0,0
934399189,934399189,,1,0,1,1,0,1,0,0,0,0,18,0,0
1412196388796960768,1412196388796960768,,1,0,1,2,0,2,0,0,0,0,18,0,0
85136737,85136737,,1,0,1,1,0,1,0,0,0,0,18,0,0
6134882,6134882,,1,0,1,1,0,1,0,0,0,0,18,0,0
472412809,472412809,,1,0,1,1,0,1,0,0,0,0,18,0,0
20675681,20675681,,1,0,1,1,0,1,0,0,0,0,18,0,0
802852196,802852196,,1,0,1,1,0,1,0,0,0,0,18,0,0
707231479047315456,707231479047315456,,1,0,1,2,0,2,0,0,0,0,18,0,0
2457084857,2457084857,,0,1,1,0,2,2,2,0.6,0.666667,0,206,0,0
345871224,345871224,,1,0,1,2,0,2,0,0,0,0,206,0,0
934709512967262208,934709512967262208,,0,1,1,0,2,2,1,1,1,0,110,0,0.000006
305236970,305236970,,1,0,1,2,0,2,0,0,0,0,28,0,0
1368110973190541312,1368110973190541312,,0,1,1,0,2,2,1,1,1,0,681,0,0
1434056766946430976,1434056766946430976,,1,0,1,2,0,2,0,0,0,0,681,0,0
1417780578561273856,1417780578561273856,,0,1,1,0,2,2,1,1,1,0,682,0,0
446477795,446477795,,1,0,1,2,0,2,0,0,0,0,682,0,0
1449478777126465536,1449478777126465536,,0,1,1,0,2,2,1,1,1,0,683,0,0
1392398509253480448,1392398509253480448,,1,0,1,2,0,2,0,0,0,0,683,0,0
1269215095185424384,1269215095185424384,,0,2,2,0,4,4,1,1,1,0,250,0,0.000023
1112292775943389184,1112292775943389184,,1,0,1,2,0,2,0,0,0,0,250,0.000001,0
477548046,477548046,,0,1,1,0,2,2,1,1,1,0,684,0,0
274093178,274093178,,1,0,1,2,0,2,0,0,0,0,684,0,0
1344976301111783424,1344976301111783424,,1,0,1,2,0,2,0,0,0,0,18,0,0
439722592,439722592,,1,0,1,2,0,2,0,0,0,0,18,0,0
1447983174710145024,1447983174710145024,,0,2,2,0,4,4,1,1,1,0,685,0,0
1422668623366213632,1422668623366213632,,1,0,1,2,0,2,0,0,0,0,685,0,0
1427548048230658048,1427548048230658048,,1,0,1,2,0,2,0,0,0,0,685,0,0
571072141,571072141,,0,1,1,0,2,2,2,0.545455,0.583333,0,17,0,0.000019
721148434,721148434,,1,0,1,4,0,4,0,0,0,0,17,0,0
1254053822546292736,1254053822546292736,,1,0,1,2,0,2,0,0,0,0,17,0,0
852633447864688640,852633447864688640,,2,0,2,4,0,4,0,0,0,0,17,0,0
2920376271,2920376271,,0,1,1,0,2,2,1,1,1,0,686,0,0
103152299,103152299,,1,0,1,2,0,2,0,0,0,0,686,0,0
518382671,518382671,,0,1,1,0,2,2,1,1,1,0,110,0,0.00002
1172469931,1172469931,,0,1,1,0,2,2,1,1,1,0,687,0,0
353160476,353160476,,1,0,1,2,0,2,0,0,0,0,687,0,0
1168040084823781376,1168040084823781376,,0,1,1,0,2,2,1,1,1,0,5,0,0.000035
1448296779804512256,1448296779804512256,,0,1,1,0,2,2,2,0.666667,0.75,0,15,0,0.000104
47747815,47747815,,0,1,1,0,2,2,1,1,1,0,688,0,0
1675887912,1675887912,,1,0,1,2,0,2,0,0,0,0,688,0,0
1441349041611153408,1441349041611153408,,0,1,1,0,2,2,1,1,1,0,689,0,0
49772158,49772158,,1,0,1,2,0,2,0,0,0,0,689,0,0
1417774216997392384,1417774216997392384,,1,0,1,2,0,2,0,0,0,0,15,0,0
2911062543,2911062543,,0,1,1,0,2,2,1,1,1,0,690,0,0
52435663,52435663,,1,0,1,2,0,2,0,0,0,0,690,0,0
1244314564835061760,1244314564835061760,,0,1,1,0,2,2,2,0.666667,0.75,0,18,0,0
1683455144,1683455144,,1,1,2,2,2,4,1,1,1,0,18,0,0.000018
1171597712611000320,1171597712611000320,,1,0,1,2,0,2,0,0,0,0,17,0,0
46224994,46224994,,1,0,1,2,0,2,0,0,0,0,17,0,0
36079217,36079217,,1,0,1,2,0,2,0,0,0,0,9,0,0
516548989,516548989,,1,0,1,2,0,2,0,0,0,0,206,0,0
40985455,40985455,,1,0,1,2,0,2,0,0,0,0,206,0,0
1636129136,1636129136,,1,0,1,2,0,2,0,0,0,0,206,0,0
167432545,167432545,,1,0,1,2,0,2,0,0,0,0,206,0,0
1426664569515253760,1426664569515253760,,1,0,1,2,0,2,0,0,0,0,9,0,0
384927198,384927198,,1,0,1,2,0,2,0,0,0,0,21,0,0
522438840,522438840,,0,1,1,0,2,2,1,1,1,0,691,0,0
58748101,58748101,,1,0,1,2,0,2,0,0,0,0,691,0,0
378431869,378431869,,0,2,2,0,4,4,1,1,1,0,692,0,0
3130154705,3130154705,,1,0,1,2,0,2,0,0,0,0,692,0,0
927756689545277440,927756689545277440,,1,0,1,2,0,2,0,0,0,0,692,0,0
750824744778403840,750824744778403840,,1,0,1,2,0,2,0,0,0,0,18,0,0
29202025,29202025,,1,0,1,2,0,2,0,0,0,0,28,0,0
872445682472411136,872445682472411136,,1,0,1,2,0,2,0,0,0,0,28,0,0
494813245,494813245,,1,0,1,2,0,2,0,0,0,0,28,0,0
1645574510,1645574510,,1,0,1,2,0,2,0,0,0,0,28,0,0
1240644888934350848,1240644888934350848,,1,0,1,2,0,2,0,0,0,0,28,0,0
1387774224572600320,1387774224572600320,,1,0,1,2,0,2,0,0,0,0,110,0,0
1322010178078859264,1322010178078859264,,1,0,1,2,0,2,0,0,0,0,21,0.000001,0
946417900985954304,946417900985954304,,1,0,1,2,0,2,0,0,0,0,21,0.000001,0
1291795656,1291795656,,0,0,0,0,0,0,0,0,0,0,693,0,0
1129447967168114688,1129447967168114688,,0,0,0,0,0,0,0,0,0,0,694,0,0
1116737494446481408,1116737494446481408,,0,1,1,0,2,2,1,1,1,0,15,0,0.00015
1407725425510522880,1407725425510522880,,0,1,1,0,2,2,1,1,1,0,695,0,0
1235060898,1235060898,,1,0,1,2,0,2,0,0,0,0,695,0,0
1077871463313653760,1077871463313653760,,0,1,1,0,2,2,1,1,1,0,696,0,0
544218009,544218009,,1,0,1,2,0,2,0,0,0,0,696,0,0
1062413818066862080,1062413818066862080,,0,1,1,0,2,2,1,1,1,0,28,0,0
1169254465632972800,1169254465632972800,,1,0,1,2,0,2,0,0,0,0,9,0,0
951246650,951246650,,1,0,1,2,0,2,0,0,0,0,9,0,0
144210805,144210805,,1,0,1,2,0,2,0,0,0,0,9,0,0
1163431789555306496,1163431789555306496,,0,1,1,0,2,2,1,1,1,0,697,0,0
784525968,784525968,,1,0,1,2,0,2,0,0,0,0,697,0,0
4492706302,4492706302,,0,1,1,0,2,2,1,1,1,0,698,0,0
432516884,432516884,,1,0,1,2,0,2,0,0,0,0,698,0,0
872835147657248768,872835147657248768,,0,1,1,0,2,2,1,1,1,0,699,0,0
466499074,466499074,,1,0,1,2,0,2,0,0,0,0,699,0,0
1321869959769841664,1321869959769841664,,0,1,1,0,2,2,1,1,1,0,700,0,0
801014415831212032,801014415831212032,,1,0,1,2,0,2,0,0,0,0,700,0,0
877230271652823040,877230271652823040,,1,0,1,2,0,2,0,0,0,0,206,0,0
256031384,256031384,,0,1,1,0,2,2,1,1,1,0,701,0,0
756840775506419712,756840775506419712,,1,0,1,2,0,2,0,0,0,0,701,0,0
1442484954995195904,1442484954995195904,,0,1,1,0,2,2,2,0.666667,0.75,0,17,0,0
608534375,608534375,,1,1,2,2,2,4,1,1,1,0,17,0,0
89952017,89952017,,0,1,1,0,2,2,1,1,1,0,702,0,0
794817312,794817312,,1,0,1,2,0,2,0,0,0,0,702,0,0
300356125,300356125,,0,1,1,0,2,2,1,1,1,0,703,0,0
436793228,436793228,,1,0,1,2,0,2,0,0,0,0,703,0,0
3031163841,3031163841,,1,0,1,2,0,2,0,0,0,0,704,0,0
2871696632,2871696632,,1,0,1,2,0,2,0,0,0,0,250,0,0
1435348483259707392,1435348483259707392,,1,0,1,4,0,4,0,0,0,0,250,0,0
365462238,365462238,,1,0,1,2,0,2,0,0,0,0,14,0,0
471867441,471867441,,1,0,1,2,0,2,0,0,0,0,15,0,0
1396129968938229760,1396129968938229760,,0,1,1,0,2,2,1,1,1,0,705,0,0
483807769,483807769,,1,0,1,2,0,2,0,0,0,0,705,0,0
1177559064911515648,1177559064911515648,,0,4,4,0,8,8,1,1,1,0,706,0,0
430169858,430169858,,1,0,1,2,0,2,0,0,0,0,706,0,0
425686235,425686235,,1,0,1,2,0,2,0,0,0,0,706,0,0
1380462850041339904,1380462850041339904,,1,0,1,2,0,2,0,0,0,0,706,0,0
1216094998258749440,1216094998258749440,,1,0,1,2,0,2,0,0,0,0,706,0,0
840871783557431296,840871783557431296,,0,0,0,0,0,0,0,0,0,0,707,0,0
1208668305696968704,1208668305696968704,,0,1,1,0,2,2,1,1,1,0,708,0,0
2446734732,2446734732,,1,0,1,2,0,2,0,0,0,0,708,0,0
860917372835827712,860917372835827712,,0,1,1,0,2,2,1,1,1,0,709,0,0
1380045464653991936,1380045464653991936,,1,0,1,2,0,2,0,0,0,0,709,0,0
1459703156,1459703156,,0,1,1,0,2,2,2,0.666667,0.75,0,710,0,0
289400495,289400495,,1,1,2,2,2,4,1,1,1,0,710,0,0
1432463182686216192,1432463182686216192,,1,0,1,2,0,2,0,0,0,0,710,0,0
2525924002,2525924002,,0,3,3,0,6,6,1,1,1,0,711,0,0
16696161,16696161,,1,0,1,2,0,2,0,0,0,0,711,0,0
2162983644,2162983644,,1,0,1,2,0,2,0,0,0,0,711,0,0
1314971039261241344,1314971039261241344,,1,0,1,2,0,2,0,0,0,0,711,0,0
45418106,45418106,,0,1,1,0,2,2,1,1,1,0,712,0,0
422152255,422152255,,1,0,1,2,0,2,0,0,0,0,712,0,0
1384554290807820288,1384554290807820288,,0,1,1,0,2,2,1,1,1,0,713,0,0
130106305,130106305,,1,0,1,2,0,2,0,0,0,0,713,0,0
828306291756060672,828306291756060672,,0,1,1,0,2,2,1,1,1,0,714,0,0
280961020,280961020,,1,0,1,2,0,2,0,0,0,0,714,0,0
1447893018498027520,1447893018498027520,,0,1,1,0,2,2,1,1,1,0,715,0,0
718093429486526464,718093429486526464,,1,0,1,2,0,2,0,0,0,0,715,0,0
1265964896090456064,1265964896090456064,,0,1,1,0,1,1,1,1,1,0,716,0,0
245059814,245059814,,1,0,1,1,0,1,0,0,0,0,716,0,0
1274238203906621440,1274238203906621440,,0,1,1,0,2,2,1,1,1,0,582,0,0
2394237095,2394237095,,0,1,1,0,2,2,1,1,1,0,717,0,0
1433747876698628096,1433747876698628096,,1,0,1,2,0,2,0,0,0,0,717,0,0
59746019,59746019,,1,0,1,2,0,2,0,0,0,0,718,0,0
402995375,402995375,,1,0,1,2,0,2,0,0,0,0,718,0,0
371781632,371781632,,0,1,1,0,2,2,1,1,1,0,719,0,0
88048507,88048507,,1,0,1,2,0,2,0,0,0,0,719,0,0
852112455660695552,852112455660695552,,0,1,1,0,2,2,1,1,1,0,720,0,0
546791475,546791475,,1,0,1,2,0,2,0,0,0,0,720,0,0
860368705498337280,860368705498337280,,1,0,1,2,0,2,0,0,0,0,28,0,0
479708002,479708002,,0,1,1,0,2,2,1,1,1,0,721,0,0
451460002,451460002,,1,0,1,2,0,2,0,0,0,0,721,0,0
76899528,76899528,,0,1,1,0,2,2,1,1,1,0,722,0,0
247863643,247863643,,1,0,1,2,0,2,0,0,0,0,722,0,0
1221534019310977024,1221534019310977024,,0,1,1,0,2,2,1,1,1,0,723,0,0
1423522280,1423522280,,1,0,1,2,0,2,0,0,0,0,723,0,0
1361437765414617088,1361437765414617088,,0,0,0,0,0,0,0,0,0,0,724,0,0
2238011889,2238011889,,0,1,1,0,2,2,1,1,1,0,725,0,0
637254997,637254997,,1,0,1,2,0,2,0,0,0,0,725,0,0
